"aa" = (/obj/effect/floor_decal/corner/white/diagonal,/obj/machinery/light_switch{pixel_y = 24},/turf/simulated/floor/tiled/dark,/area/aisat)
"ab" = (/turf/simulated/wall,/area/aisat)
"ac" = (/obj/structure/bed/chair/sofa/black/right,/turf/simulated/floor/tiled/dark,/area/aisat)
"ad" = (/obj/effect/floor_decal/corner/white/diagonal,/obj/structure/bed/chair/sofa/black,/obj/structure/plasma{pixel_x = -28; pixel_y = 32},/turf/simulated/floor/tiled/dark,/area/aisat)
"ae" = (/obj/effect/floor_decal/corner/white/diagonal,/obj/structure/bed/chair/sofa/black/left,/turf/simulated/floor/tiled/dark,/area/aisat)
"af" = (/obj/structure/sign/neon/figures/circle,/turf/simulated/wall,/area/aisat)
"ag" = (/obj/structure/table/standard,/obj/item/weapon/storage/belt/utility/full,/turf/simulated/floor/tiled/dark,/area/aisat)
"ah" = (/obj/effect/floor_decal/corner/white/diagonal,/turf/simulated/floor/tiled/dark,/area/aisat)
"ai" = (/obj/structure/sign/neon/figures/crest,/turf/simulated/wall,/area/aisat)
"aj" = (/obj/effect/floor_decal/corner/white/diagonal,/obj/machinery/holoplant,/turf/simulated/floor/tiled/dark,/area/aisat)
"ak" = (/obj/machinery/light,/turf/simulated/floor/tiled/dark,/area/aisat)
"al" = (/obj/structure/sign/neon/figures/square,/turf/simulated/wall,/area/aisat)
"am" = (/obj/structure/sign/neon/figures/triangle,/turf/simulated/wall,/area/aisat)
"an" = (/turf/simulated/floor/tiled/dark,/area/aisat)
"ao" = (/obj/effect/floor_decal/corner/white/diagonal,/obj/machinery/light/colored/green{icon_state = "green1"; dir = 1},/turf/simulated/floor/tiled/dark,/area/aisat)
"ap" = (/obj/machinery/light/floor,/turf/simulated/floor/tiled/dark,/area/aisat)
"aq" = (/obj/effect/floor_decal/corner/white/diagonal,/obj/structure/table/steel,/obj/item/device/flashlight/lamp/lava/green,/turf/simulated/floor/tiled/dark,/area/aisat)
"ar" = (/obj/structure/gas_station,/turf/simulated/floor/tiled/dark,/area/aisat)
"as" = (/obj/structure/gas_station/south,/turf/simulated/floor/tiled/dark,/area/aisat)
"au" = (/obj/structure/neon_spline/green{icon_state = "spline_fancy"; dir = 9},/obj/structure/neon_spline/red/corner,/turf/simulated/floor/tiled/dark,/area/aisat)
"ax" = (/obj/machinery/light{icon_state = "tube1"; dir = 4},/turf/simulated/floor/tiled/dark,/area/aisat)
"ay" = (/obj/structure/neon_spline/green{icon_state = "spline_fancy"; dir = 1},/obj/structure/neon_spline/red,/turf/simulated/floor/tiled/dark,/area/aisat)
"az" = (/obj/machinery/light{icon_state = "tube1"; dir = 8},/turf/simulated/floor/tiled/dark,/area/aisat)
"aA" = (/obj/structure/neon_spline/green{icon_state = "spline_fancy"; dir = 5},/obj/structure/neon_spline/red/corner{icon_state = "spline_fancy_corner"; dir = 8},/turf/simulated/floor/tiled/dark,/area/aisat)
"aB" = (/obj/effect/floor_decal/corner/white/diagonal,/obj/structure/table/standard,/obj/item/device/multitool,/turf/simulated/floor/tiled/dark,/area/aisat)
"aD" = (/obj/effect/floor_decal/corner/white/diagonal,/obj/structure/table/standard,/obj/item/clothing/gloves/yellow,/turf/simulated/floor/tiled/dark,/area/aisat)
"aE" = (/obj/structure/neon_spline/green{icon_state = "spline_fancy"; dir = 8},/obj/structure/neon_spline/red{icon_state = "spline_fancy"; dir = 4},/turf/simulated/floor/tiled/dark,/area/aisat)
"aF" = (/obj/effect/landmark{name = "JoinLate"},/obj/effect/floor_decal/corner/white/diagonal,/turf/simulated/floor/tiled/dark,/area/aisat)
"aG" = (/obj/effect/landmark/start,/turf/simulated/floor/tiled/dark,/area/aisat)
"aH" = (/obj/structure/neon_spline/green{icon_state = "spline_fancy"; dir = 4},/obj/structure/neon_spline/red{icon_state = "spline_fancy"; dir = 8},/turf/simulated/floor/tiled/dark,/area/aisat)
"aI" = (/obj/structure/neon_spline/green{icon_state = "spline_fancy"; dir = 10},/obj/structure/neon_spline/red/corner{icon_state = "spline_fancy_corner"; dir = 1},/turf/simulated/floor/tiled/dark,/area/aisat)
"aL" = (/obj/structure/neon_spline/green,/obj/structure/neon_spline/red{icon_state = "spline_fancy"; dir = 1},/turf/simulated/floor/tiled/dark,/area/aisat)
"aM" = (/obj/structure/neon_spline/green{icon_state = "spline_fancy"; dir = 6},/obj/structure/neon_spline/red/corner{icon_state = "spline_fancy_corner"; dir = 4},/turf/simulated/floor/tiled/dark,/area/aisat)
"aN" = (/obj/effect/floor_decal/corner/white/diagonal,/mob/living/carbon/human/npc/interactable/retail/testing,/turf/simulated/floor/tiled/dark,/area/aisat)
"aO" = (/obj/effect/floor_decal/corner/white/diagonal,/obj/structure/table/standard,/obj/item/weapon/spacecash/bundle/c100,/obj/item/weapon/spacecash/bundle/c100,/turf/simulated/floor/tiled/dark,/area/aisat)
"aP" = (/obj/effect/floor_decal/corner/white/diagonal,/obj/structure/table/standard,/obj/item/weapon/surgical/scalpel,/obj/item/weapon/surgical/retractor,/obj/item/weapon/surgical/hemostat,/obj/item/weapon/surgical/circular_saw,/obj/item/weapon/surgical/cautery,/obj/item/weapon/surgical/bonesetter,/obj/item/weapon/surgical/bonegel,/obj/item/weapon/surgical/bone_clamp,/obj/item/weapon/surgical/suture,/obj/item/weapon/surgical/surgicaldrill,/turf/simulated/floor/tiled/dark,/area/aisat)
"aQ" = (/obj/effect/floor_decal/corner/white/diagonal,/obj/machinery/atm,/turf/simulated/floor/tiled/dark,/area/aisat)
"aR" = (/obj/effect/floor_decal/corner/white/diagonal,/obj/structure/table/standard,/turf/simulated/floor/tiled/dark,/area/aisat)
"aS" = (/obj/effect/floor_decal/corner/white/diagonal,/obj/structure/table/standard,/obj/machinery/monitor,/turf/simulated/floor/tiled/dark,/area/aisat)
"aT" = (/obj/structure/bed/roller/adv,/turf/simulated/floor/tiled/dark,/area/aisat)
"aU" = (/obj/effect/floor_decal/corner/white/diagonal,/obj/structure/table/standard,/obj/item/weapon/paper_bin,/turf/simulated/floor/tiled/dark,/area/aisat)
"aV" = (/obj/effect/floor_decal/corner/white/diagonal,/obj/structure/table/standard,/obj/item/weapon/pen/red,/turf/simulated/floor/tiled/dark,/area/aisat)
"aW" = (/turf/simulated/wall,/area/example_mine_lift)
"aX" = (/obj/effect/floor_decal/corner/white/diagonal,/obj/structure/table/standard,/obj/item/weapon/card/id/security/detective,/turf/simulated/floor/tiled/dark,/area/aisat)
"aY" = (/obj/machinery/door/airlock,/turf/simulated/floor/tiled/dark,/area/example_mine_lift)
"aZ" = (/obj/machinery/mine_lift_button{pixel_x = -24},/turf/simulated/floor/tiled/dark,/area/example_mine_lift)
"ba" = (/turf/simulated/floor/tiled/dark,/area/example_mine_lift)
"bb" = (/obj/structure/neon_spline/purple/corner,/turf/simulated/floor/tiled/dark,/area/aisat)
"bd" = (/obj/structure/neon_spline/purple/corner{icon_state = "spline_fancy_corner"; dir = 8},/turf/simulated/floor/tiled/dark,/area/aisat)
"be" = (/obj/structure/neon_spline/purple{icon_state = "spline_fancy"; dir = 4},/turf/simulated/floor/tiled/dark,/area/aisat)
"bf" = (/obj/structure/neon_spline/purple{icon_state = "spline_fancy"; dir = 8},/turf/simulated/floor/tiled/dark,/area/aisat)
"bg" = (/obj/structure/neon_spline/purple/corner{icon_state = "spline_fancy_corner"; dir = 1},/turf/simulated/floor/tiled/dark,/area/aisat)
"bh" = (/obj/structure/neon_spline/purple{icon_state = "spline_fancy"; dir = 1},/turf/simulated/floor/tiled/dark,/area/aisat)
"bi" = (/obj/structure/neon_spline/purple/corner{icon_state = "spline_fancy_corner"; dir = 4},/turf/simulated/floor/tiled/dark,/area/aisat)

(1,1,1) = {"
abababababababababababababababababababababababababababababababababababababababababababababababababababababababababababababababababababababababababababababababababab
abanapanananananapanananananananapanananananananapanananananananapanananananananapanananananananapanananananananapanananananananapanananananananapanananananananapab
abananananananananananananananananananananananananananananananananananananananananananananananananananananananananananananananananananananananananananananananananab
abananananananananananananananananananananananananananananananananananananananananananananananananananananananananananananananananananananananananananananananananab
abananananananananananananananananananananananananananananananananananananananananananananananananananananananananananananananananananananananananananananananananab
abananananananananananananananananananananananananananananananananananananananananananananananananananananananananananananananananananananananananananananananananab
abananananananananananananananananananananananananananananananananananananananananananananananananananananananananananananananananananananananananananananananananab
abanapanananananapanananananananapanananananananapanananananananapanananananananapanananananananapanananananananapanananananananapanananananananapanananananananapab
abananananananananananananananananananananananananananananananananananananananananananananananananananananananananananananananananananananananananananananananananab
abananananananananananananananananananananananananananananananananananananananananananananananananananananananananananananananananananananananananananananananananab
abananananananananananananananananananananananananananananananananananananananananananananananananananananananananananananananananananananananananananananananananab
abananananananananananananananananananananananananananananananananananananananananananananananananananananananananananananananananananananananananananananananananab
abananananananananananananananananananananananananananananananananananananananananananananananananananananananananananananananananananananananananananananananananab
abananananananananananananananananananananananananananananananananananananananananananananananananananananananananananananananananananananananananananananananananab
abananananananananananananananananananananananananananananananananananananananananananananananananananananananananananananananananananananananananananananananananab
abanapanananananapanananananananapanananananananapanananananananapanananananananapanananananananapanananananananapanananananananapanananananananapanananananananapab
abananananananananananananananananananananananananananananananananananananananananananananananananananananananananananananananananananananananananananananananananab
abananananananananananananananananananananananananananananananananananananananananananananananananananananananananananananananananananananananananananananananananab
abananananananananananananananananananananananananananananananananananananananananananananananananananananananananananananananananananananananananananananananananab
abananananananananananananananananananananananananananananananananananananananananananananananananananananananananananananananananananananananananananananananananab
abananananananananananananananananananananananananananananananananananananananananananananananananananananananananananananananananananananananananananananananananab
abananananananananananananananananananananananananananananananananananananananananananananananananananananananananananananananananananananananananananananananananab
abananananananananananananananananananananananananananananananananananananananananananananananananananananananananananananananananananananananananananananananananab
abanapanananananapanananananananapanananananananapanananananananapanananananananapanananananananapanananananananapanananananananapanananananananapanananananananapab
abananananananananananananananananananananananananananananananananananananananananananananananananananananananananananananananananananananananananananananananananab
abananananananananananananananananananananananananananananananananananananananananananananananananananananananananananananananananananananananananananananananananab
abananananananananananananananananananananananananananananananananananananananananananananananananananananananananananananananananananananananananananananananananab
abananananananananananananananananananananananananananananananananananananananananananananananananananananananananananananananananananananananananananananananananab
abananananananananananananananananananananananananananananananananananananananananananananananananananananananananananananananananananananananananananananananananab
abananananananananananananananananananananananananananananananananananananananananananananananananananananananananananananananananananananananananananananananananab
abananananananananananananananananananananananananananananananananananananananananananananananananananananananananananananananananananananananananananananananananab
abanapanananananapanananananananapanananananananapanananananananapanananananananapanananananananapanananananananapanananananananapanananananananapanananananananapab
abananananananananananananananananananananananananananananananananananananananananananananananananananananananananananananananananananananananananananananananananab
abananananananananananananananananananananananananananananananananananananananananananananananananananananananananananananananananananananananananananananananananab
abananananananananananananananananananananananananananananananananananananananananananananananananananananananananananananananananananananananananananananananananab
abananananananananananananananananananananananananananananananananananananananananananananananananananananananananananananananananananananananananananananananananab
abananananananananananananananananananananananananananananananananananananananananananananananananananananananananananananananananananananananananananananananananab
abananananananananananananananananananananananananananananananananananananananananananananananananananananananananananananananananananananananananananananananananab
abananananananananananananananananananananananananananananananananananananananananananananananananananananananananananananananananananananananananananananananananab
abanapanananananapanananananananapanananananananapanananananananapanananananananapanananananananapanananananananapanananananananapanananananananapanananananananapab
abananananananananananananananananananananananananananananananananananananananananananananananananananananananananananananananananananananananananananananananananab
abananananananananananananananananananananananananananananananananananananananananananananananananananananananananananananananananananananananananananananananananab
abananananananananananananananananananananananananananananananananananananananananananananananananananananananananananananananananananananananananananananananananab
abananananananananananananananananananananananananananananananananananananananananananananananananananananananananananananananananananananananananananananananananab
abananananananananananananananananananananananananananananananananananananananananananananananananananananananananananananananananananananananananananananananananab
abananananananananananananananananananananananananananananananananananananananananananananananananananananananananananananananananananananananananananananananananab
abananananananananananananananananananananananananananananananananananananananananananananananananananananananananananananananananananananananananananananananananab
abanapanananananapanananananananapanananananananapanananananananapanananananananapanananananananapanananananananapanananananananapanananananananapanananananananapab
abananananananananananananananananananananananananananananananananananananananananananananananananananananananananananananananananananananananananananananananananab
abananananananananananananananananananananananananananananananananananananananananananananananananananananananananananananananananananananananananananananananananab
abananananananananananananananananananananananananananananananananananananananananananananananananananananananananananananananananananananananananananananananananab
abananananananananananananananananananananananananananananananananananananananananananananananananananananananananananananananananananananananananananananananananab
abanauayayayayayayayayayayayayayayayayayayayayayayayayayayaAanananananananananananananananananananananananananananananananananananananananananananananananananananab
abanaEananananananananananananananananananananananananananaHanananananananananananananananananananananananananananananananananananananananananananananananananananab
abanaEananananananananananananananananananananananananananaHanananananananananananananananananananananananananananananananananananananananananananananananananananab
abanaEananananananananananananananananananananananananananaHananapanananananananapanananananananapanananananananapanananananananapanananananananapanananananananapab
abanaEananananananananananananananananananananananananananaHanananananananananananananananananananananananananananananananananananananananananananananananananananab
abanaEananananananananananananananananananananananananananaHanananananananananananananananananananananananananananananananananananananananananananananananananananab
abanaEananananananananananananananananananananananananananaHanananananananananananananananananananananananananananananananananananananananananananananananananananab
abanaEanananananbbabababafaialamababababababbdananananananaHanananananananananananananananananananananananananananananananananananananananananananananananananananab
abanaEanananananbeahaaaoahahahanaoahacadaeahbfananananananaHanananananananananananananananananananananananananananananananananananananananananananananananananananab
abanaEanananananbeahahahahahahanahahajaqajahbfananananananaHanananananananananananananananananananananananananananananananananananananananananananananananananananab
abanaEanananananbeahahahahahahanahahahahahahbfananananananaHanananananananananananananananananananananananananananananananananananananananananananananananananananab
abanaEanananananbeahahahahahahanahahahahahahbfananananananaHananapanananananananapanananananananapanananananananapanananananananapanananananananapanananananananapab
abanaEanananananbeahahahaNahahanahahahahahahbfananananananaHanananananananananananananananananananananananananananananananananananananananananananananananananananab
abanaEananarasanbeahahaOaRaXaQakahahahahahahbfananananananaHanananananananananananananananananananananananananananananananananananananananananananananananananananab
abanaEanananananbeazananananaxabazananananaxbfananananananaHanananananananananananananananananananananananananananananananananananananananananananananananananananab
abanaEanananananbeahahahahahaBagaDahahahahahbfananananananaHanananananananananananananananananananananananananananananananananananananananananananananananananananab
abanaEanananananbeaUahaFaFaFahanahahaPaRaSahbfananananananaHanananananananananananananananananananananananananananananananananananananananananananananananananananab
abanaEanananananbeaVahaFaFaFahaGahahahaTahahbfananananananaHanananananananananananananananananananananananananananananananananananananananananananananananananananab
abanaEanananananbeaRahaFaFaFahanahahahahahahbfananananananaHanananananananananananananananananananananananananananananananananananananananananananananananananananab
abanaEanananananbeahahahahahahanahahahahahahbfananananananaHananapanananananananapanananananananapanananananananapanananananananapanananananananapanananananananapab
abanaEanananananbeahahahahahahakahahahahahahbfananananananaHanananananananananananananananananananananananananananananananananananananananananananananananananananab
abanaEanananananbgbhbhbhbhbhbhbhbhbhbhbhbhbhbiananananananaHanananananananananananananananananananananananananananananananananananananananananananananananananananab
abanaEanananananananananananananananananananananaWaYaYaWanaHanananananananananananananananananananananananananananananananananananananananananananananananananananab
abanaEanananananananananananananananananananananaWaZbaaWanaHanananananananananananananananananananananananananananananananananananananananananananananananananananab
abanaEanananananananananananananananananananananaWbabaaWanaHanananananananananananananananananananananananananananananananananananananananananananananananananananab
abanaEanananananananananananananananananananananaWaWaWaWanaHanananananananananananananananananananananananananananananananananananananananananananananananananananab
abanaEananananananananananananananananananananananananananaHanananananananananananananananananananananananananananananananananananananananananananananananananananab
abanaIaLaLaLaLaLaLaLaLaLaLaLaLaLaLaLaLaLaLaLaLaLaLaLaLaLaLaMananapanananananananapanananananananapanananananananapanananananananapanananananananapanananananananapab
abananananananananananananananananananananananananananananananananananananananananananananananananananananananananananananananananananananananananananananananananab
abababababababababababababababababababababababababababababababababababababababababababababababababababababababababababababababababababababababababababababababababab
"}
