//MAP CONVERTED BY dmm2tgm.py THIS HEADER COMMENT PREVENTS RECONVERSION, DO NOT REMOVE
"a" = (
/turf/simulated/mineral/impassable,
/area/space)
"b" = (
/obj/structure/stairs/west,
/turf/simulated/floor/wood/ebony,
/area/space)
"c" = (
/turf/simulated/open,
/area/space)
"d" = (
/turf/simulated/wall/concrete/fckng_invincible,
/area/space)
"e" = (
/obj/structure/stairs/east,
/turf/simulated/floor/pavement/pave_tiling,
/area/space)
"i" = (
/turf/simulated/floor/wood/ebony,
/area/space)
"m" = (
/turf/simulated/floor/tiled/white,
/area/space)
"p" = (
/obj/structure/stairs/east,
/turf/simulated/floor/wood/ebony,
/area/space)
"N" = (
/turf/simulated/floor/pavement/pave_tiling,
/area/space)
"S" = (
/turf/simulated/wall/concrete,
/area/space)

(1,1,1) = {"
a
a
a
a
a
a
a
a
a
a
a
a
a
a
a
a
a
a
a
a
a
a
a
a
a
a
a
a
a
a
a
a
a
a
a
a
a
a
a
a
a
a
a
a
a
a
a
a
a
"}
(2,1,1) = {"
a
a
a
a
a
a
a
a
a
a
a
a
a
a
a
a
a
a
a
a
a
a
a
a
a
a
a
a
a
a
a
a
a
a
a
a
a
a
a
a
a
a
a
a
a
a
a
a
a
"}
(3,1,1) = {"
a
a
a
a
a
a
a
a
a
a
a
a
a
a
a
a
a
a
a
a
a
a
a
a
a
a
a
a
a
a
a
a
a
a
a
a
a
a
a
a
a
a
a
a
a
a
a
a
a
"}
(4,1,1) = {"
a
a
a
a
a
a
a
a
a
a
a
a
a
a
a
a
a
a
a
a
a
a
a
a
a
a
a
a
a
a
a
a
a
a
a
a
a
a
a
a
a
a
a
a
a
a
a
a
a
"}
(5,1,1) = {"
a
a
a
a
a
a
a
a
a
a
a
a
a
a
a
a
a
a
a
a
a
a
a
a
a
a
a
a
a
a
a
a
a
a
a
a
a
a
a
a
a
a
a
a
a
a
a
a
a
"}
(6,1,1) = {"
a
a
a
a
a
a
a
a
a
a
a
a
a
a
a
a
a
a
a
a
a
a
a
a
a
a
a
a
a
a
a
a
a
a
a
a
a
a
a
a
a
a
a
a
a
a
a
a
a
"}
(7,1,1) = {"
a
a
a
a
a
a
a
a
a
a
a
a
a
a
a
a
a
a
a
a
a
a
a
a
a
a
a
a
a
a
a
a
a
a
a
a
a
a
a
a
a
a
a
a
a
a
a
a
a
"}
(8,1,1) = {"
a
a
a
a
a
a
a
a
a
a
a
a
a
a
a
a
a
a
a
a
a
a
a
a
a
a
a
a
a
a
a
a
a
a
a
a
a
a
a
a
a
a
a
a
a
a
a
a
a
"}
(9,1,1) = {"
a
a
a
a
a
a
a
a
a
a
a
a
a
a
a
a
a
a
a
a
a
a
a
a
a
a
a
a
a
a
a
a
a
a
a
a
a
a
a
a
a
a
a
a
a
a
a
a
a
"}
(10,1,1) = {"
a
a
a
a
a
a
a
a
a
a
a
a
a
a
a
a
a
a
a
a
a
a
a
a
a
a
a
a
a
a
a
a
a
a
a
a
a
a
a
a
a
a
a
a
a
a
a
a
a
"}
(11,1,1) = {"
a
a
a
a
a
a
a
a
a
a
a
a
a
a
a
a
a
a
a
a
a
a
a
a
a
a
a
a
a
a
a
a
a
a
a
a
a
a
a
a
a
a
a
a
a
a
a
a
a
"}
(12,1,1) = {"
a
a
a
a
a
a
a
a
a
a
a
a
a
a
a
a
a
a
a
a
a
a
a
a
a
a
a
a
a
a
a
a
a
a
a
a
a
a
a
a
a
a
a
a
a
a
a
a
a
"}
(13,1,1) = {"
a
a
a
a
a
a
a
a
a
a
a
a
a
a
a
a
a
a
a
a
a
a
a
a
a
a
a
a
a
a
a
a
a
a
a
a
a
a
a
a
a
a
a
a
a
a
a
a
a
"}
(14,1,1) = {"
a
a
a
a
a
a
a
a
a
a
a
a
a
a
a
a
a
a
a
a
a
a
a
a
a
a
a
a
a
a
a
a
a
a
a
a
a
a
a
a
a
a
a
a
a
a
a
a
a
"}
(15,1,1) = {"
a
a
a
a
a
a
a
a
a
a
a
a
a
a
a
a
a
a
a
a
a
a
a
a
a
a
a
a
a
a
a
a
a
a
a
a
a
a
a
a
a
a
a
a
a
a
a
a
a
"}
(16,1,1) = {"
a
a
a
a
a
a
a
a
a
a
a
a
a
a
a
a
a
a
a
a
a
a
a
a
a
a
a
a
a
a
a
a
a
a
a
a
a
a
a
a
a
a
a
a
a
a
a
a
a
"}
(17,1,1) = {"
a
a
a
a
a
a
a
a
a
a
a
a
a
a
a
a
a
a
a
a
a
a
a
a
a
a
a
a
a
a
a
a
a
a
a
a
a
a
a
a
a
a
a
a
a
a
a
a
a
"}
(18,1,1) = {"
a
a
a
a
a
a
a
a
a
a
a
a
a
a
a
a
a
a
a
a
a
a
a
a
a
a
a
a
a
a
a
a
a
a
a
a
a
a
a
a
a
a
a
a
a
a
a
a
a
"}
(19,1,1) = {"
a
a
a
a
a
a
a
a
a
a
a
a
a
a
a
a
a
a
a
a
a
a
a
a
a
a
a
a
a
a
a
a
a
a
a
a
a
a
a
a
a
a
a
a
a
a
a
a
a
"}
(20,1,1) = {"
a
a
a
a
a
a
a
a
a
a
a
a
a
a
a
a
a
a
a
a
a
a
a
a
a
a
a
a
a
a
a
a
a
a
a
a
a
a
a
a
a
a
a
a
a
a
a
a
a
"}
(21,1,1) = {"
a
a
a
a
a
a
a
a
a
a
a
a
a
a
a
a
a
a
a
a
a
a
a
a
a
a
a
a
a
a
a
a
a
a
a
a
a
a
a
a
a
a
a
a
a
a
a
a
a
"}
(22,1,1) = {"
a
a
a
a
a
a
a
a
a
a
a
a
a
a
a
a
a
a
a
a
a
a
a
a
a
a
a
a
a
a
a
a
a
a
a
a
a
a
a
a
a
a
a
a
a
a
a
a
a
"}
(23,1,1) = {"
a
a
a
a
a
a
a
a
a
a
a
a
a
a
a
a
a
a
a
a
a
a
a
a
a
a
a
a
a
a
a
a
a
a
a
a
a
a
a
a
a
a
a
a
a
a
a
a
a
"}
(24,1,1) = {"
a
a
a
a
a
a
a
a
a
a
a
a
a
a
a
a
a
a
a
a
a
a
a
a
a
a
a
a
a
a
a
a
a
a
a
a
a
a
a
a
a
a
a
a
a
a
a
a
a
"}
(25,1,1) = {"
a
a
a
a
a
a
a
a
a
a
a
a
a
a
a
a
a
a
a
a
a
a
a
a
a
a
a
a
a
a
a
a
a
a
a
a
a
a
a
a
a
a
a
a
a
a
a
a
a
"}
(26,1,1) = {"
a
a
a
a
a
a
a
a
a
a
a
a
a
a
a
a
a
a
a
a
a
a
a
a
a
a
a
a
a
a
a
a
a
a
a
a
a
a
a
a
a
a
a
a
a
a
a
a
a
"}
(27,1,1) = {"
a
a
a
a
a
a
a
a
a
a
a
a
a
a
a
a
a
a
a
a
a
a
a
a
a
a
a
a
a
a
a
a
a
a
a
a
a
a
a
a
a
a
a
a
a
a
a
a
a
"}
(28,1,1) = {"
a
a
a
a
a
a
a
a
a
a
a
a
a
a
a
a
a
a
a
a
a
a
a
a
a
a
a
a
a
a
a
a
a
a
a
a
a
a
a
a
a
a
a
a
a
a
a
a
a
"}
(29,1,1) = {"
a
a
a
a
a
a
a
a
a
a
a
a
a
a
a
a
a
a
a
a
b
b
a
a
a
a
a
a
a
a
a
a
a
a
a
a
a
a
a
a
a
a
a
a
a
a
a
a
a
"}
(30,1,1) = {"
a
a
a
a
a
a
a
a
a
a
a
a
a
a
a
a
a
a
a
a
i
i
a
a
a
a
a
a
a
a
a
a
a
a
a
a
a
a
a
a
a
a
a
a
a
a
a
a
a
"}
(31,1,1) = {"
a
a
a
a
a
a
a
a
a
a
a
a
a
a
a
a
a
a
a
a
i
i
a
a
a
a
a
a
a
a
a
a
a
a
a
a
a
a
a
a
a
a
a
a
a
a
a
a
a
"}
(32,1,1) = {"
a
a
a
a
a
a
a
a
a
a
a
a
a
a
a
a
a
a
a
a
i
i
a
a
a
a
a
a
a
a
a
a
a
a
a
a
a
a
a
a
a
a
a
a
a
a
a
a
a
"}
(33,1,1) = {"
a
a
a
a
a
a
a
a
a
a
a
a
a
a
a
a
a
a
a
a
i
i
a
a
a
a
a
a
a
a
a
a
a
a
a
a
a
a
a
a
a
a
a
a
a
a
a
a
a
"}
(34,1,1) = {"
a
a
a
a
a
a
a
a
a
a
a
a
a
a
a
a
a
a
a
a
i
i
a
a
a
a
a
a
a
a
a
a
a
a
a
a
a
a
a
a
a
a
a
a
a
a
a
a
a
"}
(35,1,1) = {"
a
a
a
a
a
a
a
a
a
a
a
a
a
a
a
a
a
a
a
a
i
i
a
a
a
a
a
a
a
a
a
a
a
a
a
a
a
a
a
a
a
a
a
a
a
a
a
a
a
"}
(36,1,1) = {"
a
a
a
a
a
a
a
a
a
a
a
a
a
a
a
a
a
a
a
a
i
i
a
a
a
a
a
a
a
a
a
a
a
a
a
a
a
a
a
a
a
a
a
a
a
a
a
a
a
"}
(37,1,1) = {"
a
a
a
a
a
a
a
a
a
a
a
a
a
a
a
a
a
a
a
a
i
i
a
a
a
a
a
a
a
a
a
a
a
a
a
a
a
a
a
a
a
a
a
a
a
a
a
a
a
"}
(38,1,1) = {"
a
a
a
a
a
a
a
a
a
a
a
a
a
a
a
a
a
a
a
a
i
i
a
a
a
a
a
a
a
a
a
a
a
a
a
a
a
a
a
a
a
a
a
a
a
a
a
a
a
"}
(39,1,1) = {"
a
a
a
a
a
a
a
a
a
a
a
a
a
a
a
a
a
a
a
a
i
i
a
a
a
a
a
a
a
a
a
a
a
a
a
a
a
a
a
a
a
a
a
a
a
a
a
a
a
"}
(40,1,1) = {"
a
a
a
a
a
a
a
a
a
a
a
a
a
a
a
a
a
a
a
a
i
i
a
a
a
a
a
a
a
a
a
a
a
a
a
a
a
a
a
a
a
a
a
a
a
a
a
a
a
"}
(41,1,1) = {"
a
a
a
a
a
a
a
a
a
a
a
a
a
a
a
a
a
a
a
a
i
i
a
a
a
a
a
a
a
a
a
a
a
a
a
a
a
a
a
a
a
a
a
a
a
a
a
a
a
"}
(42,1,1) = {"
a
a
a
a
a
a
a
a
a
a
a
a
a
a
a
a
a
a
a
a
i
i
a
a
a
a
a
a
a
a
a
a
a
a
a
a
a
a
a
a
a
a
a
a
a
a
a
a
a
"}
(43,1,1) = {"
a
a
a
a
a
a
a
a
a
a
a
a
a
a
a
a
a
a
a
a
a
a
a
a
a
a
a
a
a
a
a
a
a
a
a
a
a
a
a
a
a
a
a
a
a
a
a
a
a
"}
(44,1,1) = {"
a
a
a
a
a
a
a
a
a
a
a
a
a
a
a
a
a
a
a
a
a
a
a
a
a
a
a
a
a
a
a
a
a
a
a
a
a
a
a
a
a
a
a
a
a
a
a
a
a
"}
(45,1,1) = {"
a
a
a
a
a
a
a
a
a
a
a
a
a
a
a
a
a
a
a
a
a
a
a
a
a
a
a
a
a
a
a
a
a
a
a
a
a
a
a
a
a
a
a
a
a
a
a
a
a
"}
(46,1,1) = {"
a
a
a
a
a
a
a
a
a
a
a
a
a
a
a
a
a
a
a
a
a
a
a
a
a
a
a
a
a
a
a
a
a
a
a
a
a
a
a
a
a
a
a
a
a
a
a
a
a
"}
(47,1,1) = {"
a
a
a
a
a
a
a
a
a
a
a
a
a
a
a
a
a
a
a
a
a
a
a
a
a
a
a
a
a
a
a
a
a
a
a
a
a
a
a
a
a
a
a
a
a
a
a
a
a
"}
(48,1,1) = {"
a
a
a
a
a
a
a
a
a
a
a
a
a
a
a
a
a
a
a
a
a
a
a
a
a
a
a
a
a
a
a
a
a
a
a
a
a
a
a
a
a
a
a
a
a
a
a
a
a
"}
(49,1,1) = {"
a
a
a
a
a
a
a
a
a
a
a
a
a
a
a
a
a
a
a
a
a
a
a
a
a
a
a
a
a
a
a
a
a
a
a
a
a
a
a
a
a
a
a
a
a
a
a
a
a
"}
(50,1,1) = {"
a
a
a
a
a
a
a
a
a
a
a
a
a
a
a
a
a
a
a
a
a
a
a
a
a
a
a
a
a
a
a
a
a
a
a
a
a
a
a
a
a
a
a
a
a
a
a
a
a
"}
(51,1,1) = {"
a
a
a
a
a
a
a
a
a
a
a
a
a
a
a
a
a
a
a
a
a
a
a
a
a
a
a
a
a
a
a
a
a
a
a
a
a
a
a
a
a
a
a
a
a
a
a
a
a
"}
(52,1,1) = {"
a
a
a
a
a
a
a
a
a
a
a
a
a
a
a
a
a
a
a
a
a
a
a
a
a
a
a
a
a
a
a
a
a
a
a
a
a
a
a
a
a
a
a
a
a
a
a
a
a
"}
(53,1,1) = {"
a
a
a
a
a
a
a
a
a
a
a
a
a
a
a
a
a
a
a
a
a
a
a
a
a
a
a
a
a
a
a
a
a
a
a
a
a
a
a
a
a
a
a
a
a
a
a
a
a
"}
(54,1,1) = {"
a
a
a
a
a
a
a
a
a
a
a
a
a
a
a
a
a
a
a
a
a
a
a
a
a
a
a
a
a
a
a
a
a
a
a
a
a
a
a
a
a
a
a
a
a
a
a
a
a
"}
(55,1,1) = {"
a
a
a
a
a
a
a
a
a
a
a
a
a
a
a
a
a
a
a
a
a
a
a
a
a
a
a
a
a
a
a
a
a
a
a
a
a
a
a
a
a
a
a
a
a
a
a
a
a
"}

(1,1,2) = {"
d
d
d
d
d
d
d
d
d
d
d
d
d
d
d
d
d
d
d
d
d
d
d
d
d
d
d
d
d
d
d
d
d
d
d
d
d
d
d
d
d
d
d
d
d
d
d
d
N
"}
(2,1,2) = {"
d
N
N
N
N
N
N
N
N
N
N
N
N
N
N
N
N
N
N
N
N
N
N
N
N
N
N
N
N
N
N
N
N
N
N
N
N
N
N
N
N
N
N
N
N
N
N
N
N
"}
(3,1,2) = {"
d
N
S
S
S
S
S
S
S
S
S
S
S
S
S
S
S
S
S
S
S
S
S
S
S
S
S
S
S
S
S
S
S
S
S
S
S
S
S
S
S
S
S
S
S
S
S
S
N
"}
(4,1,2) = {"
d
N
S
i
i
i
i
i
S
i
i
S
i
i
S
i
i
i
i
i
S
i
i
i
i
i
i
i
i
i
i
i
i
i
i
i
i
i
i
i
i
i
i
i
i
i
i
S
N
"}
(5,1,2) = {"
d
N
S
i
i
i
i
i
S
i
i
S
i
i
S
i
i
i
i
i
S
i
i
i
i
i
i
i
i
i
i
i
i
i
i
i
i
i
i
i
i
i
i
i
i
i
i
S
N
"}
(6,1,2) = {"
d
N
S
i
i
i
i
i
S
i
i
S
i
i
S
i
i
i
i
i
S
i
i
S
S
S
S
S
S
S
S
S
S
S
S
S
S
S
S
S
S
S
S
S
S
i
S
S
N
"}
(7,1,2) = {"
d
N
S
S
S
S
i
S
S
i
i
S
i
i
S
S
i
S
S
S
S
i
i
S
i
i
i
S
i
i
i
S
m
m
m
S
m
m
m
S
i
i
i
i
i
i
i
S
N
"}
(8,1,2) = {"
d
N
S
i
i
i
i
i
i
i
i
S
i
i
i
i
i
i
i
i
S
i
i
S
i
i
i
S
i
i
i
m
m
m
m
S
m
m
m
m
i
i
i
i
i
i
i
S
N
"}
(9,1,2) = {"
d
N
S
i
i
i
i
i
i
i
i
S
i
i
i
i
i
i
i
i
S
i
i
S
i
i
i
S
i
i
i
S
m
m
m
S
m
m
m
S
i
i
i
i
i
i
i
S
N
"}
(10,1,2) = {"
d
N
S
i
i
i
i
i
i
i
i
S
i
i
i
i
i
i
i
i
S
i
i
S
i
i
i
S
i
i
i
S
m
m
m
S
m
m
m
S
i
i
i
i
i
i
i
S
N
"}
(11,1,2) = {"
d
N
S
i
i
i
S
S
S
S
S
S
S
S
S
S
S
i
i
i
S
i
i
S
S
i
S
S
i
i
i
S
S
S
S
S
S
S
S
S
i
i
i
i
i
i
i
S
N
"}
(12,1,2) = {"
d
N
S
i
i
i
S
m
m
m
m
S
m
m
m
m
S
i
i
i
S
i
i
S
i
i
i
i
i
i
i
S
i
i
i
S
i
i
i
S
i
i
S
S
S
S
S
S
N
"}
(13,1,2) = {"
d
N
S
i
i
i
m
m
m
m
m
S
m
m
m
m
m
i
i
i
S
i
i
S
i
i
i
i
i
i
i
i
i
i
i
S
i
i
i
i
i
i
S
i
i
i
i
S
N
"}
(14,1,2) = {"
d
N
S
i
i
i
S
m
m
m
m
S
m
m
m
m
S
i
i
i
S
i
i
S
i
i
i
i
i
i
i
S
i
i
i
S
i
i
i
S
i
i
S
i
i
i
i
S
N
"}
(15,1,2) = {"
d
N
S
S
i
S
S
S
S
S
S
S
S
S
S
S
S
S
i
S
S
i
i
S
i
i
i
i
i
i
i
S
i
i
i
S
i
i
i
S
i
i
i
i
i
i
i
S
N
"}
(16,1,2) = {"
d
N
S
i
i
i
i
i
i
i
i
i
i
i
i
i
i
i
i
i
i
i
i
S
i
i
i
i
i
i
i
S
i
i
i
S
i
i
i
S
i
i
S
i
i
i
i
S
N
"}
(17,1,2) = {"
d
N
S
i
i
i
i
i
i
i
i
i
i
i
i
i
i
i
i
i
i
i
i
S
i
i
i
i
i
i
i
S
i
i
i
S
i
i
i
S
i
i
S
i
i
i
i
S
N
"}
(18,1,2) = {"
d
N
S
i
i
S
i
S
S
S
S
S
S
S
S
S
i
S
S
i
i
S
S
S
S
S
S
S
S
S
S
S
S
S
S
S
S
S
S
S
S
S
S
S
S
S
S
S
N
"}
(19,1,2) = {"
d
N
S
i
i
S
i
i
S
i
i
S
i
i
S
i
i
S
i
i
i
i
S
N
N
N
N
N
N
N
N
N
N
N
N
N
N
N
N
N
N
N
N
N
N
N
N
N
N
"}
(20,1,2) = {"
d
N
S
i
i
S
i
i
S
i
i
S
i
i
S
i
i
S
i
i
i
i
S
N
N
N
N
N
N
N
N
N
N
N
N
N
N
N
N
N
N
N
N
N
N
N
N
N
N
"}
(21,1,2) = {"
d
N
S
i
i
S
i
i
i
i
i
S
i
i
i
i
i
S
i
i
i
i
S
N
N
N
N
N
N
N
N
N
N
N
N
N
N
N
N
N
N
N
N
N
N
N
N
N
N
"}
(22,1,2) = {"
d
N
S
i
i
S
i
i
S
i
i
S
i
i
S
i
i
S
i
i
i
i
S
N
N
N
N
N
N
N
N
N
N
N
N
N
N
N
N
N
N
N
N
N
N
N
N
N
N
"}
(23,1,2) = {"
d
N
S
i
i
S
i
i
S
S
S
S
S
S
S
i
i
S
i
i
i
i
S
N
N
N
N
N
N
N
N
N
N
N
N
N
N
N
N
N
N
N
N
N
N
N
N
N
N
"}
(24,1,2) = {"
d
N
S
i
i
S
i
i
i
i
i
S
i
i
i
i
i
S
i
i
i
i
S
N
N
N
N
N
N
N
N
N
N
N
N
N
N
N
N
N
N
N
N
N
N
N
N
N
N
"}
(25,1,2) = {"
d
N
S
i
i
S
i
i
i
i
i
S
i
i
i
i
i
S
i
i
i
i
i
N
N
N
N
N
N
N
N
N
N
N
N
N
N
N
N
N
N
N
N
N
N
N
N
N
N
"}
(26,1,2) = {"
d
N
S
i
i
S
i
i
i
i
i
S
i
i
i
i
i
S
i
i
i
i
i
N
N
N
N
N
N
N
N
N
N
N
N
N
N
N
N
N
N
N
N
N
N
N
N
N
N
"}
(27,1,2) = {"
d
N
S
i
i
S
i
i
i
i
i
S
i
i
i
i
i
S
i
i
i
i
S
N
N
N
N
N
N
N
N
N
N
N
N
N
N
N
N
N
N
N
N
N
N
N
N
N
N
"}
(28,1,2) = {"
d
N
S
i
i
S
i
i
i
i
i
S
i
i
i
i
i
S
i
i
i
i
S
N
N
N
N
N
N
N
N
N
N
N
N
N
N
N
N
N
N
N
N
N
N
N
N
N
N
"}
(29,1,2) = {"
d
N
S
i
i
S
i
S
S
S
S
S
S
S
S
S
i
S
i
i
c
c
S
N
N
N
N
N
N
N
N
N
N
S
S
S
S
S
S
S
S
S
S
S
S
S
S
S
N
"}
(30,1,2) = {"
d
N
S
i
i
S
i
i
i
i
i
S
i
i
i
i
i
S
p
p
c
c
S
N
N
N
N
N
N
N
N
N
N
S
i
i
i
i
i
i
i
i
i
i
i
i
i
S
N
"}
(31,1,2) = {"
d
N
S
i
i
S
i
i
i
i
i
S
i
i
i
i
i
S
S
S
S
S
S
N
N
N
N
N
N
N
N
N
N
S
i
i
i
i
i
i
i
i
i
i
i
i
i
S
N
"}
(32,1,2) = {"
d
N
S
i
i
S
i
i
i
i
i
S
i
i
i
i
i
S
S
S
S
S
S
N
N
N
N
N
N
N
N
N
N
S
i
i
i
i
i
i
i
i
i
i
i
i
i
S
N
"}
(33,1,2) = {"
d
N
S
i
i
S
S
S
S
S
S
S
S
S
S
S
S
S
S
S
S
S
S
N
N
N
N
N
N
N
N
N
N
S
i
i
i
i
i
i
i
i
i
i
i
i
i
S
N
"}
(34,1,2) = {"
d
N
S
i
i
S
m
m
m
S
i
i
i
i
S
i
i
S
N
N
N
N
N
N
N
N
N
N
N
N
N
N
N
S
i
i
i
i
i
i
i
i
i
i
i
i
i
S
N
"}
(35,1,2) = {"
d
N
S
i
i
S
m
m
m
S
i
i
i
i
S
i
i
S
N
N
N
N
N
N
N
N
N
N
N
N
N
N
N
S
i
i
i
i
i
i
i
i
i
i
i
i
i
S
N
"}
(36,1,2) = {"
d
N
S
i
i
S
m
m
m
S
i
i
i
i
S
i
i
S
N
N
N
N
N
N
N
N
N
N
N
N
N
N
N
S
i
i
i
i
i
i
i
i
i
i
i
i
i
S
N
"}
(37,1,2) = {"
d
N
S
i
i
S
m
m
m
S
i
i
i
i
S
i
i
S
N
N
N
N
N
N
N
N
N
N
N
N
N
N
N
S
i
i
i
i
i
i
i
i
i
i
i
i
i
S
N
"}
(38,1,2) = {"
d
N
S
i
i
S
S
m
S
S
S
S
i
S
S
i
i
S
N
N
N
N
N
N
N
N
N
N
N
N
N
N
N
S
i
i
i
i
i
i
i
i
i
i
i
i
i
S
N
"}
(39,1,2) = {"
d
N
S
i
i
S
i
i
i
i
i
i
i
i
i
i
i
S
N
N
N
N
N
N
N
N
N
N
N
N
N
N
N
S
i
i
i
i
i
i
i
i
i
i
i
i
i
S
N
"}
(40,1,2) = {"
d
N
S
i
i
i
i
i
i
i
i
i
i
i
i
i
i
S
N
N
N
N
N
N
N
N
N
N
N
N
N
N
N
S
i
i
i
i
i
i
i
i
i
i
i
i
i
S
N
"}
(41,1,2) = {"
d
N
S
i
i
S
i
i
i
i
i
i
i
i
i
i
i
S
N
N
N
N
N
N
N
N
N
N
N
N
N
N
N
S
i
i
i
i
i
i
i
i
i
i
i
i
i
S
N
"}
(42,1,2) = {"
d
N
S
i
i
S
i
i
i
i
i
i
i
i
i
i
i
S
N
N
N
N
N
N
N
N
N
N
N
N
N
N
N
S
i
i
i
i
i
i
i
i
i
i
i
i
i
S
N
"}
(43,1,2) = {"
d
N
S
i
i
S
i
i
i
i
i
i
i
i
i
i
i
S
N
N
N
N
N
N
N
N
N
N
N
N
N
N
N
S
i
i
i
i
i
i
i
i
i
i
i
i
i
S
N
"}
(44,1,2) = {"
d
N
S
i
i
S
S
S
S
S
S
S
S
S
S
S
S
S
N
N
N
N
N
N
N
N
N
N
N
N
e
N
N
S
i
i
i
i
i
i
i
i
i
i
i
i
i
S
N
"}
(45,1,2) = {"
d
N
S
i
i
S
m
m
m
S
i
i
i
i
S
i
i
S
N
N
N
N
N
N
N
N
N
N
N
N
N
N
N
S
i
i
i
i
i
i
i
i
i
i
i
i
i
S
N
"}
(46,1,2) = {"
d
N
S
i
i
S
m
m
m
S
i
i
i
i
S
i
i
S
N
N
N
N
N
N
N
N
N
N
N
N
N
N
N
S
i
i
i
i
i
i
i
i
i
i
i
i
i
S
N
"}
(47,1,2) = {"
d
N
S
i
i
S
m
m
m
S
i
i
i
i
S
i
i
S
N
N
N
N
N
N
N
N
N
N
N
N
N
N
N
S
i
i
i
i
i
i
i
i
i
i
i
i
i
S
N
"}
(48,1,2) = {"
d
N
S
i
i
S
m
m
m
S
i
i
i
i
S
i
i
S
N
N
N
N
N
N
N
N
N
N
N
N
N
N
N
S
i
i
i
i
i
i
i
i
i
i
i
i
i
S
N
"}
(49,1,2) = {"
d
N
S
i
i
S
S
m
S
S
S
S
i
S
S
i
i
S
N
N
N
N
N
N
N
N
N
N
N
N
N
N
N
S
i
i
i
i
i
i
i
i
i
i
i
i
i
S
N
"}
(50,1,2) = {"
d
N
S
i
i
S
i
i
i
i
i
i
i
i
i
i
i
S
N
N
N
N
N
N
N
N
N
N
N
N
N
N
N
S
i
i
i
i
i
i
i
i
i
i
i
i
i
S
N
"}
(51,1,2) = {"
d
N
S
i
i
i
i
i
i
i
i
i
i
i
i
i
i
S
N
N
N
N
N
N
N
N
N
N
N
N
N
N
N
S
i
i
i
i
i
i
i
i
i
i
i
i
i
S
N
"}
(52,1,2) = {"
d
N
S
i
i
S
i
i
i
i
i
i
i
i
i
i
i
S
N
N
N
N
N
N
N
N
N
N
N
N
N
N
N
S
i
i
i
i
i
i
i
i
i
i
i
i
i
S
N
"}
(53,1,2) = {"
d
N
S
i
i
S
i
i
i
i
i
i
i
i
i
i
i
S
N
N
N
N
N
N
N
N
N
N
N
N
N
N
N
S
i
i
i
i
i
i
i
i
i
i
i
i
i
S
N
"}
(54,1,2) = {"
d
N
S
i
i
S
i
i
i
i
i
i
i
i
i
i
i
S
N
N
N
N
N
N
N
N
N
N
N
N
N
N
N
S
i
i
i
i
i
i
i
i
i
i
i
i
i
S
N
"}
(55,1,2) = {"
d
N
S
S
S
S
S
S
S
S
S
S
S
S
S
S
S
S
N
N
N
N
N
N
N
N
N
N
N
N
N
N
N
S
S
S
S
S
S
S
S
S
S
S
S
S
S
S
N
"}

(1,1,3) = {"
c
c
c
c
c
c
c
c
c
c
c
c
c
c
c
c
c
c
c
c
c
c
c
c
c
c
c
c
c
c
c
c
c
c
c
c
c
c
c
c
c
c
c
c
c
c
c
c
c
"}
(2,1,3) = {"
c
c
c
c
c
c
c
c
c
c
c
c
c
c
c
c
c
c
c
c
c
c
c
c
c
c
c
c
c
c
c
c
c
c
c
c
c
c
c
c
c
c
c
c
c
c
c
c
c
"}
(3,1,3) = {"
c
c
S
S
S
S
S
S
S
S
S
S
S
S
S
S
S
S
S
S
S
S
S
S
S
S
S
S
S
S
S
S
S
S
S
S
S
S
S
S
S
S
S
S
S
S
S
S
S
"}
(4,1,3) = {"
c
c
S
i
i
i
i
i
i
i
i
i
i
i
i
i
i
i
i
i
i
S
i
i
i
i
i
i
i
i
i
i
i
i
i
i
i
i
i
i
i
i
i
i
i
i
i
i
S
"}
(5,1,3) = {"
c
c
S
i
i
i
i
i
i
i
i
i
i
i
i
i
i
i
i
i
i
S
i
i
i
i
i
i
i
i
i
i
i
i
i
i
i
i
i
i
i
i
i
i
i
i
i
i
S
"}
(6,1,3) = {"
c
c
S
i
i
i
i
i
i
i
i
i
i
i
i
i
i
i
i
i
i
S
i
i
i
i
i
i
i
i
i
i
i
i
i
i
i
i
i
i
i
i
i
i
i
i
i
i
S
"}
(7,1,3) = {"
c
c
S
i
i
i
i
i
i
i
i
i
i
i
i
i
i
i
i
i
i
S
i
i
i
i
i
i
i
i
i
i
i
i
i
i
i
i
i
i
i
i
i
i
i
i
i
i
S
"}
(8,1,3) = {"
c
c
S
i
i
i
i
i
i
i
i
i
i
i
i
i
i
i
i
i
i
S
i
i
i
i
i
i
i
i
i
i
i
i
i
i
i
i
i
i
i
i
i
i
i
i
i
i
S
"}
(9,1,3) = {"
c
c
S
i
i
i
i
i
i
i
i
i
i
i
i
i
i
i
i
i
i
S
i
i
i
i
i
i
i
i
i
i
i
i
i
i
i
i
i
i
i
i
i
i
i
i
i
i
S
"}
(10,1,3) = {"
c
c
S
i
i
i
i
i
i
i
i
i
i
i
i
i
i
i
i
i
i
S
i
i
i
i
i
i
i
i
i
i
i
i
i
i
i
i
i
i
i
i
i
i
i
i
i
i
S
"}
(11,1,3) = {"
c
c
S
i
i
i
i
i
i
i
i
i
i
i
i
i
i
i
i
i
i
S
i
i
i
i
i
i
i
i
i
i
i
i
i
i
i
i
i
i
i
i
i
i
i
i
i
i
S
"}
(12,1,3) = {"
c
c
S
i
i
i
i
i
i
i
i
i
i
i
i
i
i
i
i
i
i
S
i
i
i
i
i
i
i
i
i
i
i
i
i
i
i
i
i
i
i
i
i
i
i
i
i
i
S
"}
(13,1,3) = {"
c
c
S
i
i
i
i
i
i
i
i
i
i
i
i
i
i
i
i
i
i
S
i
i
i
i
i
i
i
i
i
i
i
i
i
i
i
i
i
i
i
i
i
i
i
i
i
i
S
"}
(14,1,3) = {"
c
c
S
i
i
i
i
i
i
i
i
i
i
i
i
i
i
i
i
i
i
S
i
i
i
i
i
i
i
i
i
i
i
i
i
i
i
i
i
i
i
i
i
i
i
i
i
i
S
"}
(15,1,3) = {"
c
c
S
S
S
S
S
S
S
S
S
S
S
S
S
S
S
S
S
S
S
S
i
i
i
i
i
i
i
i
i
i
i
i
i
i
i
i
i
i
i
i
i
i
i
i
i
i
S
"}
(16,1,3) = {"
c
c
S
i
i
i
i
i
i
i
i
i
i
i
i
i
i
i
i
i
i
i
i
i
i
i
i
i
i
i
i
i
i
i
i
i
i
i
i
i
i
i
i
i
i
i
i
i
S
"}
(17,1,3) = {"
c
c
S
i
i
i
i
i
i
i
i
i
i
i
i
i
i
i
i
i
i
i
i
i
i
i
i
i
i
i
i
i
i
i
i
i
i
i
i
i
i
i
i
i
i
i
i
i
S
"}
(18,1,3) = {"
c
c
S
i
i
S
S
S
S
S
S
S
S
S
S
S
S
S
S
S
S
S
i
i
S
S
S
S
S
S
S
S
S
S
i
i
i
i
i
i
i
i
i
i
i
i
i
i
S
"}
(19,1,3) = {"
c
c
S
i
i
S
i
i
i
i
i
i
i
i
i
i
i
i
i
i
i
S
i
i
S
c
c
c
c
c
c
c
c
S
i
i
i
i
i
i
i
i
i
i
i
i
i
i
S
"}
(20,1,3) = {"
c
c
S
i
i
S
i
i
i
i
i
i
i
i
i
i
i
i
i
i
i
S
i
i
S
c
c
c
c
c
c
c
c
S
i
i
i
i
i
i
i
i
i
i
i
i
i
i
S
"}
(21,1,3) = {"
c
c
S
i
i
S
i
i
i
i
i
i
i
i
i
i
i
i
i
i
i
S
i
i
S
c
c
c
c
c
c
c
c
S
i
i
i
i
i
i
i
i
i
i
i
i
i
i
S
"}
(22,1,3) = {"
c
c
S
i
i
S
i
i
i
i
i
i
i
i
i
i
i
i
i
i
i
S
i
i
S
c
c
c
c
c
c
c
c
S
i
i
i
i
i
i
i
i
i
i
i
i
i
i
S
"}
(23,1,3) = {"
c
c
S
i
i
S
i
i
i
i
i
i
i
i
i
i
i
i
i
i
i
S
i
i
S
c
c
c
c
c
c
c
c
S
i
i
i
i
i
i
i
i
i
i
i
i
i
i
S
"}
(24,1,3) = {"
c
c
S
i
i
S
i
i
i
i
i
i
i
i
i
i
i
i
i
i
i
S
i
i
S
c
c
c
c
c
c
c
c
S
i
i
i
i
i
i
i
i
i
i
i
i
i
i
S
"}
(25,1,3) = {"
c
c
S
i
i
S
i
i
i
i
i
i
i
i
i
i
i
i
i
i
i
S
i
i
S
c
c
c
c
c
c
c
c
S
i
i
i
i
i
i
i
i
i
i
i
i
i
i
S
"}
(26,1,3) = {"
c
c
S
i
i
S
i
i
i
i
i
i
i
i
i
i
i
i
i
i
i
S
i
i
S
c
c
c
c
c
c
c
c
S
i
i
i
i
i
i
i
i
i
i
i
i
i
i
S
"}
(27,1,3) = {"
c
c
S
i
i
S
i
i
i
i
i
i
i
i
i
i
i
i
i
i
i
S
i
i
S
c
c
c
c
c
c
c
c
S
i
i
i
i
i
i
i
i
i
i
i
i
i
i
S
"}
(28,1,3) = {"
c
c
S
i
i
S
i
i
i
i
i
i
i
i
i
i
i
S
S
S
S
S
i
i
S
c
c
c
c
c
c
c
c
S
i
i
i
i
i
i
i
i
i
i
i
i
i
i
S
"}
(29,1,3) = {"
c
c
S
i
i
S
i
i
i
i
i
i
i
i
i
i
i
S
c
c
b
b
i
i
S
c
c
c
c
c
c
c
c
S
i
i
i
i
i
i
i
i
i
i
i
i
i
i
S
"}
(30,1,3) = {"
c
c
S
i
i
S
i
i
i
i
i
i
i
i
i
i
i
S
c
c
i
i
i
i
S
c
c
c
c
c
c
c
c
S
i
i
i
i
i
i
i
i
i
i
i
i
i
i
S
"}
(31,1,3) = {"
c
c
S
i
i
S
i
i
i
i
i
i
i
i
i
i
i
S
i
i
i
i
i
i
S
c
c
c
c
c
c
c
c
S
i
i
i
i
i
i
i
i
i
i
i
i
i
i
S
"}
(32,1,3) = {"
c
c
S
i
i
S
i
i
i
i
i
i
i
i
i
i
i
S
i
i
i
i
i
i
S
c
c
c
c
c
c
c
c
S
i
i
i
i
i
i
i
i
i
i
i
i
i
i
S
"}
(33,1,3) = {"
c
c
S
i
i
S
i
i
i
i
i
i
i
i
i
i
i
S
S
S
S
S
S
S
S
c
c
c
c
c
c
c
c
S
i
i
i
i
i
i
i
i
i
i
i
i
i
i
S
"}
(34,1,3) = {"
c
c
S
i
i
S
i
i
i
i
i
i
i
i
i
i
i
S
c
c
c
c
c
c
c
c
c
c
c
c
c
c
c
S
i
i
i
i
i
i
i
i
i
i
i
i
i
i
S
"}
(35,1,3) = {"
c
c
S
i
i
S
i
i
i
i
i
i
i
i
i
i
i
S
c
c
c
c
c
c
c
c
c
c
c
c
c
c
c
S
i
i
i
i
i
i
i
i
i
i
i
i
i
i
S
"}
(36,1,3) = {"
c
c
S
i
i
S
i
i
i
i
i
i
i
i
i
i
i
S
c
c
c
c
c
c
c
c
c
c
c
c
c
c
c
S
i
i
i
i
i
i
i
i
i
i
i
i
i
i
S
"}
(37,1,3) = {"
c
c
S
i
i
S
i
i
i
i
i
i
i
i
i
i
i
S
c
c
c
c
c
c
c
c
c
c
c
c
c
c
c
S
i
i
i
i
i
i
i
i
i
i
i
i
i
i
S
"}
(38,1,3) = {"
c
c
S
i
i
S
i
i
i
i
i
i
i
i
i
i
i
S
c
c
c
c
c
c
c
c
c
c
c
c
c
c
c
S
i
i
i
i
i
i
i
i
i
i
i
i
i
i
S
"}
(39,1,3) = {"
c
c
S
i
i
S
i
i
i
i
i
i
i
i
i
i
i
S
c
c
c
c
c
c
c
c
c
c
c
c
c
c
c
S
i
i
i
i
i
i
i
i
i
i
i
i
i
i
S
"}
(40,1,3) = {"
c
c
S
i
i
S
i
i
i
i
i
i
i
i
i
i
i
S
c
c
c
c
c
c
c
c
c
c
c
c
c
c
c
S
i
i
i
i
i
i
i
i
i
i
i
i
i
i
S
"}
(41,1,3) = {"
c
c
S
i
i
S
i
i
i
i
i
i
i
i
i
i
i
S
c
c
c
c
c
c
c
c
c
c
c
c
c
c
c
S
i
i
i
i
i
i
i
i
i
i
i
i
i
i
S
"}
(42,1,3) = {"
c
c
S
i
i
S
i
i
i
i
i
i
i
i
i
i
i
S
c
c
c
c
c
c
c
c
c
c
c
c
c
c
c
S
i
i
i
i
i
i
i
i
i
i
i
i
i
i
S
"}
(43,1,3) = {"
c
c
S
i
i
S
i
i
i
i
i
i
i
i
i
i
i
S
c
c
c
c
c
c
c
c
c
c
c
c
c
c
c
S
i
i
i
i
i
i
i
i
i
i
i
i
i
i
S
"}
(44,1,3) = {"
c
c
S
i
i
S
i
i
i
i
i
i
i
i
i
i
i
S
c
c
c
c
c
c
c
c
c
c
c
c
c
c
c
S
i
i
i
i
i
i
i
i
i
i
i
i
i
i
S
"}
(45,1,3) = {"
c
c
S
i
i
S
i
i
i
i
i
i
i
i
i
i
i
S
c
c
c
c
c
c
c
c
c
c
c
c
c
c
c
S
i
i
i
i
i
i
i
i
i
i
i
i
i
i
S
"}
(46,1,3) = {"
c
c
S
i
i
S
i
i
i
i
i
i
i
i
i
i
i
S
c
c
c
c
c
c
c
c
c
c
c
c
c
c
c
S
i
i
i
i
i
i
i
i
i
i
i
i
i
i
S
"}
(47,1,3) = {"
c
c
S
i
i
S
i
i
i
i
i
i
i
i
i
i
i
S
c
c
c
c
c
c
c
c
c
c
c
c
c
c
c
S
i
i
i
i
i
i
i
i
i
i
i
i
i
i
S
"}
(48,1,3) = {"
c
c
S
i
i
S
i
i
i
i
i
i
i
i
i
i
i
S
c
c
c
c
c
c
c
c
c
c
c
c
c
c
c
S
i
i
i
i
i
i
i
i
i
i
i
i
i
i
S
"}
(49,1,3) = {"
c
c
S
i
i
S
i
i
i
i
i
i
i
i
i
i
i
S
c
c
c
c
c
c
c
c
c
c
c
c
c
c
c
S
i
i
i
i
i
i
i
i
i
i
i
i
i
i
S
"}
(50,1,3) = {"
c
c
S
i
i
S
i
i
i
i
i
i
i
i
i
i
i
S
c
c
c
c
c
c
c
c
c
c
c
c
c
c
c
S
i
i
i
i
i
i
i
i
i
i
i
i
i
i
S
"}
(51,1,3) = {"
c
c
S
i
i
S
i
i
i
i
i
i
i
i
i
i
i
S
c
c
c
c
c
c
c
c
c
c
c
c
c
c
c
S
i
i
i
i
i
i
i
i
i
i
i
i
i
i
S
"}
(52,1,3) = {"
c
c
S
i
i
S
i
i
i
i
i
i
i
i
i
i
i
S
c
c
c
c
c
c
c
c
c
c
c
c
c
c
c
S
i
i
i
i
i
i
i
i
i
i
i
i
i
i
S
"}
(53,1,3) = {"
c
c
S
i
i
S
i
i
i
i
i
i
i
i
i
i
i
S
c
c
c
c
c
c
c
c
c
c
c
c
c
c
c
S
i
i
i
i
i
i
i
i
i
i
i
i
i
i
S
"}
(54,1,3) = {"
c
c
S
i
i
S
i
i
i
i
i
i
i
i
i
i
i
S
c
c
c
c
c
c
c
c
c
c
c
c
c
c
c
S
i
i
i
i
i
i
i
i
i
i
i
i
i
i
S
"}
(55,1,3) = {"
c
c
S
S
S
S
S
S
S
S
S
S
S
S
S
S
S
S
c
c
c
c
c
c
c
c
c
c
c
c
c
c
c
S
S
S
S
S
S
S
S
S
S
S
S
S
S
S
S
"}

(1,1,4) = {"
c
c
c
c
c
c
c
c
c
c
c
c
c
c
c
c
c
c
c
c
c
c
c
c
c
c
c
c
c
c
c
c
c
c
c
c
c
c
c
c
c
c
c
c
c
c
c
c
c
"}
(2,1,4) = {"
c
c
c
c
c
c
c
c
c
c
c
c
c
c
c
c
c
c
c
c
c
c
c
c
c
c
c
c
c
c
c
c
c
c
c
c
c
c
c
c
c
c
c
c
c
c
c
c
c
"}
(3,1,4) = {"
c
c
S
S
S
S
S
S
S
S
S
S
S
S
S
S
S
S
S
S
S
S
S
S
S
S
S
S
S
S
S
S
S
S
S
S
S
S
S
S
S
S
S
S
S
S
S
S
S
"}
(4,1,4) = {"
c
c
S
c
c
c
c
c
c
c
c
c
c
c
c
c
c
c
c
c
c
c
c
c
c
c
c
c
c
c
c
c
c
c
c
c
c
c
c
c
c
c
c
c
c
c
c
c
S
"}
(5,1,4) = {"
c
c
S
c
c
c
c
c
c
c
c
c
c
c
c
c
c
c
c
c
c
c
c
c
c
c
c
c
c
c
c
c
c
c
c
c
c
c
c
c
c
c
c
c
c
c
c
c
S
"}
(6,1,4) = {"
c
c
S
c
c
c
c
c
c
c
c
c
c
c
c
c
c
c
c
c
c
c
c
c
c
c
c
c
c
c
c
c
c
c
c
c
c
c
c
c
c
c
c
c
c
c
c
c
S
"}
(7,1,4) = {"
c
c
S
c
c
c
c
c
c
c
c
c
c
c
c
c
c
c
c
c
c
c
c
c
c
c
c
c
c
c
c
c
c
c
c
c
c
c
c
c
c
c
c
c
c
c
c
c
S
"}
(8,1,4) = {"
c
c
S
c
c
c
c
c
c
c
c
c
c
c
c
c
c
c
c
c
c
c
c
c
c
c
c
c
c
c
c
c
c
c
c
c
c
c
c
c
c
c
c
c
c
c
c
c
S
"}
(9,1,4) = {"
c
c
S
c
c
c
c
c
c
c
c
c
c
c
c
c
c
c
c
c
c
c
c
c
c
c
c
c
c
c
c
c
c
c
c
c
c
c
c
c
c
c
c
c
c
c
c
c
S
"}
(10,1,4) = {"
c
c
S
c
c
c
c
c
c
c
c
c
c
c
c
c
c
c
c
c
c
c
c
c
c
c
c
c
c
c
c
c
c
c
c
c
c
c
c
c
c
c
c
c
c
c
c
c
S
"}
(11,1,4) = {"
c
c
S
c
c
c
c
c
c
c
c
c
c
c
c
c
c
c
c
c
c
c
c
c
c
c
c
c
c
c
c
c
c
c
c
c
c
c
c
c
c
c
c
c
c
c
c
c
S
"}
(12,1,4) = {"
c
c
S
c
c
c
c
c
c
c
c
c
c
c
c
c
c
c
c
c
c
c
c
c
c
c
c
c
c
c
c
c
c
c
c
c
c
c
c
c
c
c
c
c
c
c
c
c
S
"}
(13,1,4) = {"
c
c
S
c
c
c
c
c
c
c
c
c
c
c
c
c
c
c
c
c
c
c
c
c
c
c
c
c
c
c
c
c
c
c
c
c
c
c
c
c
c
c
c
c
c
c
c
c
S
"}
(14,1,4) = {"
c
c
S
c
c
c
c
c
c
c
c
c
c
c
c
c
c
c
c
c
c
c
c
c
c
c
c
c
c
c
c
c
c
c
c
c
c
c
c
c
c
c
c
c
c
c
c
c
S
"}
(15,1,4) = {"
c
c
S
c
c
c
c
c
c
c
c
c
c
c
c
c
c
c
c
c
c
c
c
c
c
c
c
c
c
c
c
c
c
c
c
c
c
c
c
c
c
c
c
c
c
c
c
c
S
"}
(16,1,4) = {"
c
c
S
c
c
c
c
c
c
c
c
c
c
c
c
c
c
c
c
c
c
c
i
i
c
c
c
c
c
c
c
c
c
c
c
c
c
c
c
c
c
c
c
c
c
c
c
c
S
"}
(17,1,4) = {"
c
c
S
c
c
c
c
c
c
c
c
c
c
c
c
c
c
c
c
c
c
c
i
i
c
c
c
c
c
c
c
c
c
c
c
c
c
c
c
c
c
c
c
c
c
c
c
c
S
"}
(18,1,4) = {"
c
c
S
c
c
c
c
c
c
c
c
c
c
c
c
c
c
c
c
c
c
c
i
i
S
S
S
S
S
S
S
S
S
S
c
c
c
c
c
c
c
c
c
c
c
c
c
c
S
"}
(19,1,4) = {"
c
c
S
c
c
c
c
c
c
c
c
c
c
c
c
c
c
c
c
c
c
c
i
i
S
c
c
c
c
c
c
c
c
S
c
c
c
c
c
c
c
c
c
c
c
c
c
c
S
"}
(20,1,4) = {"
c
c
S
c
c
c
c
c
c
c
c
c
c
c
c
c
c
c
c
c
c
c
i
i
S
c
c
c
c
c
c
c
c
S
c
c
c
c
c
c
c
c
c
c
c
c
c
c
S
"}
(21,1,4) = {"
c
c
S
c
c
c
c
c
c
c
c
c
c
c
c
c
c
c
c
c
c
c
i
i
S
c
c
c
c
c
c
c
c
S
c
c
c
c
c
c
c
c
c
c
c
c
c
c
S
"}
(22,1,4) = {"
c
c
S
c
c
c
c
c
c
c
c
c
c
c
c
c
c
c
c
c
c
c
i
i
S
c
c
c
c
c
c
c
c
S
c
c
c
c
c
c
c
c
c
c
c
c
c
c
S
"}
(23,1,4) = {"
c
c
S
c
c
c
c
c
c
c
c
c
c
c
c
c
c
c
c
c
c
c
i
i
S
c
c
c
c
c
c
c
c
S
c
c
c
c
c
c
c
c
c
c
c
c
c
c
S
"}
(24,1,4) = {"
c
c
S
c
c
c
c
c
c
c
c
c
c
c
c
c
c
c
c
c
c
c
i
i
S
c
c
c
c
c
c
c
c
S
c
c
c
c
c
c
c
c
c
c
c
c
c
c
S
"}
(25,1,4) = {"
c
c
S
c
c
c
c
c
c
c
c
c
c
c
c
c
c
c
c
c
c
c
i
i
S
c
c
c
c
c
c
c
c
S
c
c
c
c
c
c
c
c
c
c
c
c
c
c
S
"}
(26,1,4) = {"
c
c
S
c
c
c
c
c
c
c
c
c
c
c
c
c
c
c
c
c
c
c
i
i
S
c
c
c
c
c
c
c
c
S
c
c
c
c
c
c
c
c
c
c
c
c
c
c
S
"}
(27,1,4) = {"
c
c
S
c
c
c
c
c
c
c
c
c
c
c
c
c
c
c
i
i
i
i
i
i
S
c
c
c
c
c
c
c
c
S
c
c
c
c
c
c
c
c
c
c
c
c
c
c
S
"}
(28,1,4) = {"
c
c
S
c
c
c
c
c
c
c
c
c
c
c
c
c
c
c
i
i
i
i
i
i
S
c
c
c
c
c
c
c
c
S
c
c
c
c
c
c
c
c
c
c
c
c
c
c
S
"}
(29,1,4) = {"
c
c
S
c
c
c
c
c
c
c
c
c
c
c
c
c
c
c
i
i
c
c
S
S
S
c
c
c
c
c
c
c
c
S
c
c
c
c
c
c
c
c
c
c
c
c
c
c
S
"}
(30,1,4) = {"
c
c
S
c
c
c
c
c
c
c
c
c
c
c
c
c
c
c
i
i
c
c
S
c
c
c
c
c
c
c
c
c
c
S
c
c
c
c
c
c
c
c
c
c
c
c
c
c
S
"}
(31,1,4) = {"
c
c
S
c
c
c
c
c
c
c
c
c
c
c
c
c
c
S
S
S
S
S
S
c
c
c
c
c
c
c
c
c
c
S
c
c
c
c
c
c
c
c
c
c
c
c
c
c
S
"}
(32,1,4) = {"
c
c
S
c
c
c
c
c
c
c
c
c
c
c
c
c
c
S
c
c
c
c
c
c
c
c
c
c
c
c
c
c
c
S
c
c
c
c
c
c
c
c
c
c
c
c
c
c
S
"}
(33,1,4) = {"
c
c
S
c
c
c
c
c
c
c
c
c
c
c
c
c
c
S
c
c
c
c
c
c
c
c
c
c
c
c
c
c
c
S
c
c
c
c
c
c
c
c
c
c
c
c
c
c
S
"}
(34,1,4) = {"
c
c
S
c
c
c
c
c
c
c
c
c
c
c
c
c
c
S
c
c
c
c
c
c
c
c
c
c
c
c
c
c
c
S
c
c
c
c
c
c
c
c
c
c
c
c
c
c
S
"}
(35,1,4) = {"
c
c
S
c
c
c
c
c
c
c
c
c
c
c
c
c
c
S
c
c
c
c
c
c
c
c
c
c
c
c
c
c
c
S
c
c
c
c
c
c
c
c
c
c
c
c
c
c
S
"}
(36,1,4) = {"
c
c
S
c
c
c
c
c
c
c
c
c
c
c
c
c
c
S
c
c
c
c
c
c
c
c
c
c
c
c
c
c
c
S
c
c
c
c
c
c
c
c
c
c
c
c
c
c
S
"}
(37,1,4) = {"
c
c
S
c
c
c
c
c
c
c
c
c
c
c
c
c
c
S
c
c
c
c
c
c
c
c
c
c
c
c
c
c
c
S
c
c
c
c
c
c
c
c
c
c
c
c
c
c
S
"}
(38,1,4) = {"
c
c
S
c
c
c
c
c
c
c
c
c
c
c
c
c
c
S
c
c
c
c
c
c
c
c
c
c
c
c
c
c
c
S
c
c
c
c
c
c
c
c
c
c
c
c
c
c
S
"}
(39,1,4) = {"
c
c
S
c
c
c
c
c
c
c
c
c
c
c
c
c
c
S
c
c
c
c
c
c
c
c
c
c
c
c
c
c
c
S
c
c
c
c
c
c
c
c
c
c
c
c
c
c
S
"}
(40,1,4) = {"
c
c
S
c
c
c
c
c
c
c
c
c
c
c
c
c
c
S
c
c
c
c
c
c
c
c
c
c
c
c
c
c
c
S
c
c
c
c
c
c
c
c
c
c
c
c
c
c
S
"}
(41,1,4) = {"
c
c
S
c
c
c
c
c
c
c
c
c
c
c
c
c
c
S
c
c
c
c
c
c
c
c
c
c
c
c
c
c
c
S
c
c
c
c
c
c
c
c
c
c
c
c
c
c
S
"}
(42,1,4) = {"
c
c
S
c
c
c
c
c
c
c
c
c
c
c
c
c
c
S
c
c
c
c
c
c
c
c
c
c
c
c
c
c
c
S
c
c
c
c
c
c
c
c
c
c
c
c
c
c
S
"}
(43,1,4) = {"
c
c
S
c
c
c
c
c
c
c
c
c
c
c
c
c
c
S
c
c
c
c
c
c
c
c
c
c
c
c
c
c
c
S
c
c
c
c
c
c
c
c
c
c
c
c
c
c
S
"}
(44,1,4) = {"
c
c
S
c
c
c
c
c
c
c
c
c
c
c
c
c
c
S
c
c
c
c
c
c
c
c
c
c
c
c
c
c
c
S
c
c
c
c
c
c
c
c
c
c
c
c
c
c
S
"}
(45,1,4) = {"
c
c
S
c
c
c
c
c
c
c
c
c
c
c
c
c
c
S
c
c
c
c
c
c
c
c
c
c
c
c
c
c
c
S
c
c
c
c
c
c
c
c
c
c
c
c
c
c
S
"}
(46,1,4) = {"
c
c
S
c
c
c
c
c
c
c
c
c
c
c
c
c
c
S
c
c
c
c
c
c
c
c
c
c
c
c
c
c
c
S
c
c
c
c
c
c
c
c
c
c
c
c
c
c
S
"}
(47,1,4) = {"
c
c
S
c
c
c
c
c
c
c
c
c
c
c
c
c
c
S
c
c
c
c
c
c
c
c
c
c
c
c
c
c
c
S
c
c
c
c
c
c
c
c
c
c
c
c
c
c
S
"}
(48,1,4) = {"
c
c
S
c
c
c
c
c
c
c
c
c
c
c
c
c
c
S
c
c
c
c
c
c
c
c
c
c
c
c
c
c
c
S
c
c
c
c
c
c
c
c
c
c
c
c
c
c
S
"}
(49,1,4) = {"
c
c
S
c
c
c
c
c
c
c
c
c
c
c
c
c
c
S
c
c
c
c
c
c
c
c
c
c
c
c
c
c
c
S
c
c
c
c
c
c
c
c
c
c
c
c
c
c
S
"}
(50,1,4) = {"
c
c
S
c
c
c
c
c
c
c
c
c
c
c
c
c
c
S
c
c
c
c
c
c
c
c
c
c
c
c
c
c
c
S
c
c
c
c
c
c
c
c
c
c
c
c
c
c
S
"}
(51,1,4) = {"
c
c
S
c
c
c
c
c
c
c
c
c
c
c
c
c
c
S
c
c
c
c
c
c
c
c
c
c
c
c
c
c
c
S
c
c
c
c
c
c
c
c
c
c
c
c
c
c
S
"}
(52,1,4) = {"
c
c
S
c
c
c
c
c
c
c
c
c
c
c
c
c
c
S
c
c
c
c
c
c
c
c
c
c
c
c
c
c
c
S
c
c
c
c
c
c
c
c
c
c
c
c
c
c
S
"}
(53,1,4) = {"
c
c
S
c
c
c
c
c
c
c
c
c
c
c
c
c
c
S
c
c
c
c
c
c
c
c
c
c
c
c
c
c
c
S
c
c
c
c
c
c
c
c
c
c
c
c
c
c
S
"}
(54,1,4) = {"
c
c
S
c
c
c
c
c
c
c
c
c
c
c
c
c
c
S
c
c
c
c
c
c
c
c
c
c
c
c
c
c
c
S
c
c
c
c
c
c
c
c
c
c
c
c
c
c
S
"}
(55,1,4) = {"
c
c
S
S
S
S
S
S
S
S
S
S
S
S
S
S
S
S
c
c
c
c
c
c
c
c
c
c
c
c
c
c
c
S
S
S
S
S
S
S
S
S
S
S
S
S
S
S
S
"}
