//MAP CONVERTED BY dmm2tgm.py THIS HEADER COMMENT PREVENTS RECONVERSION, DO NOT REMOVE
"a" = (
/turf/simulated/floor/pavement/pave_tiling,
/area/space)
"b" = (
/obj/machinery/light/normal_lamp2{
	icon_state = "streetlight";
	dir = 1
	},
/turf/simulated/floor/pavement/border{
	icon_state = "pavementt";
	dir = 1
	},
/area/space)
"c" = (
/obj/item/weapon/caution/cone,
/turf/simulated/floor/pavement/border{
	icon_state = "pavementt";
	dir = 1
	},
/area/space)
"d" = (
/turf/simulated/wall/iron/silver_paint,
/area/space)
"e" = (
/obj/structure/table/home_wooden,
/obj/machinery/light/floor,
/obj/structure/neon_spline/blue{
	dir = 1
	},
/turf/simulated/floor/pavement/pave_tiling,
/area/space)
"f" = (
/obj/structure/sign/neon/trafficsign/pedestrian_crossing,
/turf/simulated/floor/pavement{
	dir = 4;
	icon_state = "pavement";
	tag = "icon-pavement (EAST)"
	},
/area/space)
"g" = (
/obj/structure/sign/neon/trafficsign/circle_move{
	layer = 4.3
	},
/turf/simulated/floor/pavement/border{
	icon_state = "pavementt";
	dir = 8
	},
/area/space)
"i" = (
/obj/structure/manhole,
/turf/simulated/floor/pavement/pave_tiling,
/area/space)
"k" = (
/obj/machinery/light/normal_lamp2{
	icon_state = "streetlight";
	dir = 4
	},
/turf/simulated/floor/pavement{
	dir = 4;
	icon_state = "pavement";
	tag = "icon-pavement (EAST)"
	},
/area/space)
"l" = (
/obj/structure/billboard{
	pixel_x = -16;
	plane = -11
	},
/turf/simulated/floor/pavement/border{
	icon_state = "pavementt";
	dir = 8
	},
/area/space)
"m" = (
/obj/structure/ladder,
/turf/simulated/floor/pavement/pave_tiling,
/area/space)
"n" = (
/turf/simulated/floor/pavement/corner{
	dir = 8;
	icon_state = "pave_corner";
	tag = "icon-pave_corner (WEST)"
	},
/area/space)
"o" = (
/turf/simulated/floor/pavement/border{
	icon_state = "pavementt";
	dir = 8
	},
/area/space)
"p" = (
/obj/machinery/light/normal_lamp2{
	dir = 8;
	icon_state = "streetlight";
	plane = -14
	},
/turf/simulated/floor/pavement/border{
	icon_state = "pavementt";
	dir = 8
	},
/area/space)
"q" = (
/obj/structure/sign/neon/trafficsign/pedestrian_crossing,
/turf/simulated/floor/pavement/border{
	icon_state = "pavementt";
	dir = 1
	},
/area/space)
"r" = (
/obj/structure/neon_spline/blue/corner{
	dir = 4;
	icon_state = "spline_fancy_corner"
	},
/turf/simulated/floor/pavement/pave_tiling,
/area/space)
"s" = (
/turf/simulated/floor/pavement{
	dir = 4;
	icon_state = "pavement";
	tag = "icon-pavement (EAST)"
	},
/area/space)
"u" = (
/turf/simulated/floor/pavement/border{
	icon_state = "pavementt";
	dir = 1
	},
/area/space)
"w" = (
/obj/structure/closet/crate/bin,
/turf/simulated/floor/pavement/pave_tiling,
/area/space)
"x" = (
/obj/structure/neon_spline/blue{
	dir = 1
	},
/turf/simulated/floor/pavement/pave_tiling,
/area/space)
"B" = (
/obj/structure/bed/chair/general_alt2{
	icon_state = "metal_chair_folding";
	dir = 4
	},
/turf/simulated/floor/pavement/pave_tiling,
/area/space)
"D" = (
/turf/space,
/area/space)
"E" = (
/turf/simulated/floor/pavement/corner{
	dir = 1;
	icon_state = "pave_corner";
	tag = "icon-pave_corner (NORTH)"
	},
/area/space)
"F" = (
/obj/machinery/light/floor,
/turf/simulated/floor/pavement/pave_tiling,
/area/space)
"G" = (
/obj/machinery/light/normal_lamp2{
	dir = 1;
	icon_state = "streetlightcorner";
	plane = -10
	},
/turf/simulated/floor/pavement/corner_invert{
	dir = 8;
	icon_state = "pave_invert_corner";
	tag = "icon-pave_invert_corner (WEST)"
	},
/area/space)
"I" = (
/obj/item/weapon/caution/cone{
	pixel_x = -8;
	pixel_y = 16
	},
/turf/simulated/floor/pavement/pave_tiling,
/area/space)
"L" = (
/obj/machinery/light/normal_lamp2{
	dir = 8;
	icon_state = "streetlight";
	plane = -10
	},
/turf/simulated/floor/pavement/border{
	icon_state = "pavementt";
	dir = 8
	},
/area/space)
"M" = (
/obj/machinery/light/normal_lamp2{
	icon_state = "streetlightcorner";
	dir = 4
	},
/turf/simulated/floor/pavement{
	dir = 4;
	icon_state = "pavement";
	tag = "icon-pavement (EAST)"
	},
/area/space)
"N" = (
/obj/structure/table/home_wooden,
/turf/simulated/floor/pavement/pave_tiling,
/area/space)
"O" = (
/obj/machinery/street/traffic{
	dir = 8;
	icon_state = "off";
	pixel_x = -64;
	plane = -14
	},
/turf/simulated/floor/pavement/border{
	icon_state = "pavementt";
	dir = 1
	},
/area/space)
"P" = (
/obj/structure/neon_spline/blue/corner{
	dir = 1;
	icon_state = "spline_fancy_corner"
	},
/turf/simulated/floor/pavement/pave_tiling,
/area/space)
"Q" = (
/obj/machinery/street/traffic,
/turf/simulated/floor/pavement{
	dir = 4;
	icon_state = "pavement";
	tag = "icon-pavement (EAST)"
	},
/area/space)
"S" = (
/obj/machinery/light/colored/blue{
	dir = 1
	},
/obj/structure/neon_spline/blue{
	dir = 1
	},
/turf/simulated/floor/pavement/pave_tiling,
/area/space)
"T" = (
/obj/machinery/light/colored/blue{
	dir = 1
	},
/obj/structure/bed/chair/general_alt2{
	icon_state = "metal_chair_folding";
	dir = 4
	},
/obj/structure/neon_spline/blue{
	dir = 1
	},
/turf/simulated/floor/pavement/pave_tiling,
/area/space)
"U" = (
/obj/structure/bed/chair/general_alt2{
	dir = 8;
	icon_state = "metal_chair_folding"
	},
/turf/simulated/floor/pavement/pave_tiling,
/area/space)
"V" = (
/turf/simulated/floor/road/empty,
/area/space)
"W" = (
/obj/structure/billboard{
	pixel_x = -16
	},
/turf/simulated/floor/pavement/border{
	icon_state = "pavementt";
	dir = 4
	},
/area/space)
"X" = (
/obj/structure/sign/neon/peace,
/obj/structure/neon_spline/blue{
	dir = 1
	},
/turf/simulated/floor/pavement/pave_tiling,
/area/space)
"Y" = (
/obj/structure/bed/chair/general_alt2{
	dir = 8;
	icon_state = "metal_chair_folding"
	},
/obj/structure/neon_spline/blue{
	dir = 1
	},
/turf/simulated/floor/pavement/pave_tiling,
/area/space)

(1,1,1) = {"
V
n
o
o
o
o
o
o
o
o
p
g
o
o
o
o
o
o
L
o
o
o
o
o
l
o
L
o
o
o
o
"}
(2,1,1) = {"
n
G
a
a
a
a
a
a
a
a
a
a
a
a
a
a
a
a
a
a
i
a
a
a
a
a
a
a
a
a
a
"}
(3,1,1) = {"
u
a
a
d
d
d
d
d
d
d
d
d
d
d
d
d
d
d
d
d
d
d
d
d
d
d
d
d
d
d
a
"}
(4,1,1) = {"
u
I
a
d
a
a
a
a
a
a
a
a
a
a
a
a
a
a
a
a
a
a
a
a
a
a
a
a
a
d
a
"}
(5,1,1) = {"
c
m
i
d
a
a
a
a
a
a
a
a
a
a
a
a
a
a
a
a
a
a
a
a
a
a
a
a
a
d
a
"}
(6,1,1) = {"
u
a
a
d
a
a
a
a
a
a
a
a
a
a
a
a
a
a
a
a
a
a
a
a
a
a
a
a
a
d
a
"}
(7,1,1) = {"
u
a
a
d
a
a
a
a
a
a
a
a
a
a
a
a
a
a
a
a
a
a
a
a
a
a
a
a
a
d
a
"}
(8,1,1) = {"
u
a
a
d
a
a
a
a
a
a
a
a
a
a
a
a
a
a
a
a
a
a
a
a
a
a
a
a
a
d
a
"}
(9,1,1) = {"
b
a
a
d
a
a
a
a
a
a
a
a
a
a
a
a
a
a
a
a
a
a
a
a
a
a
a
a
a
d
a
"}
(10,1,1) = {"
u
a
a
d
a
a
a
a
a
a
a
a
a
a
a
a
a
a
a
a
a
a
a
a
a
a
a
a
a
d
a
"}
(11,1,1) = {"
u
a
a
d
a
a
a
a
a
a
a
a
a
a
a
a
a
a
a
a
a
a
a
a
a
a
a
a
a
d
a
"}
(12,1,1) = {"
u
a
a
d
a
a
a
a
a
a
a
a
a
a
a
a
a
a
a
a
a
a
a
a
a
a
a
a
a
d
a
"}
(13,1,1) = {"
q
a
a
d
a
a
a
a
a
a
a
a
a
a
a
a
a
a
a
a
a
a
a
a
a
a
a
a
a
d
a
"}
(14,1,1) = {"
u
a
a
d
a
a
a
a
a
a
a
a
a
a
a
a
a
a
a
a
a
a
a
a
a
a
a
a
a
d
a
"}
(15,1,1) = {"
u
a
a
d
a
a
a
a
a
a
a
a
a
a
a
a
a
a
a
a
a
a
a
a
a
a
a
a
a
d
a
"}
(16,1,1) = {"
u
a
a
d
a
a
a
a
a
a
a
a
a
a
a
a
a
a
a
a
a
a
a
a
a
a
a
a
a
d
a
"}
(17,1,1) = {"
b
a
a
d
a
a
a
a
a
a
a
a
a
a
a
a
a
a
a
a
a
a
a
a
a
a
a
a
a
d
B
"}
(18,1,1) = {"
u
a
a
d
a
a
a
a
a
a
a
a
a
a
a
a
a
a
a
a
a
a
a
a
a
a
a
a
a
d
N
"}
(19,1,1) = {"
u
a
a
d
a
a
a
a
a
a
a
a
a
a
a
a
a
a
a
a
a
a
a
a
a
a
a
a
a
d
U
"}
(20,1,1) = {"
u
a
a
d
a
a
a
a
a
a
a
a
a
a
a
a
a
a
a
a
a
a
a
a
a
a
a
a
a
d
a
"}
(21,1,1) = {"
u
a
a
d
a
a
a
a
a
a
a
a
a
a
a
a
a
a
a
a
a
a
a
a
a
a
a
a
a
d
a
"}
(22,1,1) = {"
u
a
a
d
a
a
a
a
a
a
a
a
a
a
a
a
a
a
a
a
a
a
a
a
a
a
a
a
a
d
a
"}
(23,1,1) = {"
O
a
a
d
a
a
a
a
a
a
a
a
a
a
a
a
a
a
a
a
a
a
a
a
a
a
a
a
a
d
a
"}
(24,1,1) = {"
u
a
a
d
a
a
a
a
a
a
a
a
a
a
a
a
a
a
a
a
a
a
a
a
a
a
a
a
a
d
a
"}
(25,1,1) = {"
u
a
a
d
a
a
a
a
a
a
a
a
a
a
a
a
a
a
a
a
a
a
a
a
a
a
a
a
a
d
a
"}
(26,1,1) = {"
u
a
a
d
a
a
a
a
a
a
a
a
a
a
a
a
a
a
a
a
a
a
a
a
a
a
a
a
a
d
a
"}
(27,1,1) = {"
u
a
a
d
a
a
a
a
a
a
a
a
a
a
a
a
a
a
a
a
a
a
a
a
a
a
a
a
a
d
a
"}
(28,1,1) = {"
u
a
a
d
a
a
a
a
a
a
a
a
a
a
a
a
a
a
a
a
a
a
a
a
a
a
a
a
a
d
a
"}
(29,1,1) = {"
u
a
a
d
a
a
a
a
a
a
a
a
a
a
a
a
a
a
a
a
a
a
a
a
a
a
a
a
a
d
a
"}
(30,1,1) = {"
u
a
a
d
a
a
a
a
a
a
a
a
a
a
a
a
a
a
a
a
a
a
a
a
a
a
a
a
a
d
P
"}
(31,1,1) = {"
u
a
a
d
a
a
a
a
a
a
a
a
a
a
a
a
a
a
a
a
a
a
a
a
a
a
a
a
a
d
x
"}
(32,1,1) = {"
u
a
a
d
a
a
a
a
a
a
a
a
a
a
a
a
a
a
a
a
a
a
a
a
a
a
a
a
a
d
T
"}
(33,1,1) = {"
b
a
a
d
a
a
a
a
a
a
a
a
a
a
a
a
a
a
a
a
a
a
a
a
a
a
a
a
a
d
e
"}
(34,1,1) = {"
u
a
a
d
a
a
a
a
a
a
a
a
a
a
a
a
a
a
a
a
a
a
a
a
a
a
a
a
a
d
Y
"}
(35,1,1) = {"
u
a
a
d
a
a
a
a
a
a
a
a
a
a
a
a
a
a
a
a
a
a
a
a
a
a
a
a
a
d
X
"}
(36,1,1) = {"
u
a
a
d
a
a
a
a
a
a
a
a
a
a
a
a
a
a
a
a
a
a
a
a
a
a
a
a
a
d
x
"}
(37,1,1) = {"
u
a
a
d
a
a
a
a
a
a
a
a
a
a
a
a
a
a
a
a
a
a
a
a
a
a
a
a
a
d
S
"}
(38,1,1) = {"
u
a
a
d
a
a
a
a
a
a
a
a
a
a
a
a
a
a
a
a
a
a
a
a
a
a
a
a
a
d
r
"}
(39,1,1) = {"
u
a
a
d
a
a
a
a
a
a
a
a
a
a
a
a
a
a
a
a
a
a
a
a
a
a
a
a
a
d
a
"}
(40,1,1) = {"
u
a
a
d
a
a
a
a
a
a
a
a
a
a
a
a
a
a
a
a
a
a
a
a
a
a
a
a
a
d
F
"}
(41,1,1) = {"
u
a
a
d
d
d
d
d
d
d
d
d
d
d
d
d
d
d
d
d
d
d
d
d
d
d
d
d
d
d
a
"}
(42,1,1) = {"
u
w
a
a
a
a
a
a
a
a
a
a
a
a
a
a
a
a
a
a
a
a
a
a
a
a
a
a
a
a
a
"}
(43,1,1) = {"
E
M
s
s
s
s
s
s
s
s
k
W
s
s
s
s
f
s
k
s
s
s
s
s
s
s
k
s
Q
s
s
"}

(1,1,2) = {"
D
D
D
D
D
D
D
D
D
D
D
D
D
D
D
D
D
D
D
D
D
D
D
D
D
D
D
D
D
D
D
"}
(2,1,2) = {"
D
D
D
D
D
D
D
D
D
D
D
D
D
D
D
D
D
D
D
D
D
D
D
D
D
D
D
D
D
D
D
"}
(3,1,2) = {"
D
D
D
D
D
D
D
D
D
D
D
D
D
D
D
D
D
D
D
D
D
D
D
D
D
D
D
D
D
D
D
"}
(4,1,2) = {"
D
D
D
D
D
D
D
D
D
D
D
D
D
D
D
D
D
D
D
D
D
D
D
D
D
D
D
D
D
D
D
"}
(5,1,2) = {"
D
D
D
D
D
D
D
D
D
D
D
D
D
D
D
D
D
D
D
D
D
D
D
D
D
D
D
D
D
D
D
"}
(6,1,2) = {"
D
D
D
D
D
D
D
D
D
D
D
D
D
D
D
D
D
D
D
D
D
D
D
D
D
D
D
D
D
D
D
"}
(7,1,2) = {"
D
D
D
D
D
D
D
D
D
D
D
D
D
D
D
D
D
D
D
D
D
D
D
D
D
D
D
D
D
D
D
"}
(8,1,2) = {"
D
D
D
D
D
D
D
D
D
D
D
D
D
D
D
D
D
D
D
D
D
D
D
D
D
D
D
D
D
D
D
"}
(9,1,2) = {"
D
D
D
D
D
D
D
D
D
D
D
D
D
D
D
D
D
D
D
D
D
D
D
D
D
D
D
D
D
D
D
"}
(10,1,2) = {"
D
D
D
D
D
D
D
D
D
D
D
D
D
D
D
D
D
D
D
D
D
D
D
D
D
D
D
D
D
D
D
"}
(11,1,2) = {"
D
D
D
D
D
D
D
D
D
D
D
D
D
D
D
D
D
D
D
D
D
D
D
D
D
D
D
D
D
D
D
"}
(12,1,2) = {"
D
D
D
D
D
D
D
D
D
D
D
D
D
D
D
D
D
D
D
D
D
D
D
D
D
D
D
D
D
D
D
"}
(13,1,2) = {"
D
D
D
D
D
D
D
D
D
D
D
D
D
D
D
D
D
D
D
D
D
D
D
D
D
D
D
D
D
D
D
"}
(14,1,2) = {"
D
D
D
D
D
D
D
D
D
D
D
D
D
D
D
D
D
D
D
D
D
D
D
D
D
D
D
D
D
D
D
"}
(15,1,2) = {"
D
D
D
D
D
D
D
D
D
D
D
D
D
D
D
D
D
D
D
D
D
D
D
D
D
D
D
D
D
D
D
"}
(16,1,2) = {"
D
D
D
D
D
D
D
D
D
D
D
D
D
D
D
D
D
D
D
D
D
D
D
D
D
D
D
D
D
D
D
"}
(17,1,2) = {"
D
D
D
D
D
D
D
D
D
D
D
D
D
D
D
D
D
D
D
D
D
D
D
D
D
D
D
D
D
D
D
"}
(18,1,2) = {"
D
D
D
D
D
D
D
D
D
D
D
D
D
D
D
D
D
D
D
D
D
D
D
D
D
D
D
D
D
D
D
"}
(19,1,2) = {"
D
D
D
D
D
D
D
D
D
D
D
D
D
D
D
D
D
D
D
D
D
D
D
D
D
D
D
D
D
D
D
"}
(20,1,2) = {"
D
D
D
D
D
D
D
D
D
D
D
D
D
D
D
D
D
D
D
D
D
D
D
D
D
D
D
D
D
D
D
"}
(21,1,2) = {"
D
D
D
D
D
D
D
D
D
D
D
D
D
D
D
D
D
D
D
D
D
D
D
D
D
D
D
D
D
D
D
"}
(22,1,2) = {"
D
D
D
D
D
D
D
D
D
D
D
D
D
D
D
D
D
D
D
D
D
D
D
D
D
D
D
D
D
D
D
"}
(23,1,2) = {"
D
D
D
D
D
D
D
D
D
D
D
D
D
D
D
D
D
D
D
D
D
D
D
D
D
D
D
D
D
D
D
"}
(24,1,2) = {"
D
D
D
D
D
D
D
D
D
D
D
D
D
D
D
D
D
D
D
D
D
D
D
D
D
D
D
D
D
D
D
"}
(25,1,2) = {"
D
D
D
D
D
D
D
D
D
D
D
D
D
D
D
D
D
D
D
D
D
D
D
D
D
D
D
D
D
D
D
"}
(26,1,2) = {"
D
D
D
D
D
D
D
D
D
D
D
D
D
D
D
D
D
D
D
D
D
D
D
D
D
D
D
D
D
D
D
"}
(27,1,2) = {"
D
D
D
D
D
D
D
D
D
D
D
D
D
D
D
D
D
D
D
D
D
D
D
D
D
D
D
D
D
D
D
"}
(28,1,2) = {"
D
D
D
D
D
D
D
D
D
D
D
D
D
D
D
D
D
D
D
D
D
D
D
D
D
D
D
D
D
D
D
"}
(29,1,2) = {"
D
D
D
D
D
D
D
D
D
D
D
D
D
D
D
D
D
D
D
D
D
D
D
D
D
D
D
D
D
D
D
"}
(30,1,2) = {"
D
D
D
D
D
D
D
D
D
D
D
D
D
D
D
D
D
D
D
D
D
D
D
D
D
D
D
D
D
D
D
"}
(31,1,2) = {"
D
D
D
D
D
D
D
D
D
D
D
D
D
D
D
D
D
D
D
D
D
D
D
D
D
D
D
D
D
D
D
"}
(32,1,2) = {"
D
D
D
D
D
D
D
D
D
D
D
D
D
D
D
D
D
D
D
D
D
D
D
D
D
D
D
D
D
D
D
"}
(33,1,2) = {"
D
D
D
D
D
D
D
D
D
D
D
D
D
D
D
D
D
D
D
D
D
D
D
D
D
D
D
D
D
D
D
"}
(34,1,2) = {"
D
D
D
D
D
D
D
D
D
D
D
D
D
D
D
D
D
D
D
D
D
D
D
D
D
D
D
D
D
D
D
"}
(35,1,2) = {"
D
D
D
D
D
D
D
D
D
D
D
D
D
D
D
D
D
D
D
D
D
D
D
D
D
D
D
D
D
D
D
"}
(36,1,2) = {"
D
D
D
D
D
D
D
D
D
D
D
D
D
D
D
D
D
D
D
D
D
D
D
D
D
D
D
D
D
D
D
"}
(37,1,2) = {"
D
D
D
D
D
D
D
D
D
D
D
D
D
D
D
D
D
D
D
D
D
D
D
D
D
D
D
D
D
D
D
"}
(38,1,2) = {"
D
D
D
D
D
D
D
D
D
D
D
D
D
D
D
D
D
D
D
D
D
D
D
D
D
D
D
D
D
D
D
"}
(39,1,2) = {"
D
D
D
D
D
D
D
D
D
D
D
D
D
D
D
D
D
D
D
D
D
D
D
D
D
D
D
D
D
D
D
"}
(40,1,2) = {"
D
D
D
D
D
D
D
D
D
D
D
D
D
D
D
D
D
D
D
D
D
D
D
D
D
D
D
D
D
D
D
"}
(41,1,2) = {"
D
D
D
D
D
D
D
D
D
D
D
D
D
D
D
D
D
D
D
D
D
D
D
D
D
D
D
D
D
D
D
"}
(42,1,2) = {"
D
D
D
D
D
D
D
D
D
D
D
D
D
D
D
D
D
D
D
D
D
D
D
D
D
D
D
D
D
D
D
"}
(43,1,2) = {"
D
D
D
D
D
D
D
D
D
D
D
D
D
D
D
D
D
D
D
D
D
D
D
D
D
D
D
D
D
D
D
"}

(1,1,3) = {"
D
D
D
D
D
D
D
D
D
D
D
D
D
D
D
D
D
D
D
D
D
D
D
D
D
D
D
D
D
D
D
"}
(2,1,3) = {"
D
D
D
D
D
D
D
D
D
D
D
D
D
D
D
D
D
D
D
D
D
D
D
D
D
D
D
D
D
D
D
"}
(3,1,3) = {"
D
D
D
D
D
D
D
D
D
D
D
D
D
D
D
D
D
D
D
D
D
D
D
D
D
D
D
D
D
D
D
"}
(4,1,3) = {"
D
D
D
D
D
D
D
D
D
D
D
D
D
D
D
D
D
D
D
D
D
D
D
D
D
D
D
D
D
D
D
"}
(5,1,3) = {"
D
D
D
D
D
D
D
D
D
D
D
D
D
D
D
D
D
D
D
D
D
D
D
D
D
D
D
D
D
D
D
"}
(6,1,3) = {"
D
D
D
D
D
D
D
D
D
D
D
D
D
D
D
D
D
D
D
D
D
D
D
D
D
D
D
D
D
D
D
"}
(7,1,3) = {"
D
D
D
D
D
D
D
D
D
D
D
D
D
D
D
D
D
D
D
D
D
D
D
D
D
D
D
D
D
D
D
"}
(8,1,3) = {"
D
D
D
D
D
D
D
D
D
D
D
D
D
D
D
D
D
D
D
D
D
D
D
D
D
D
D
D
D
D
D
"}
(9,1,3) = {"
D
D
D
D
D
D
D
D
D
D
D
D
D
D
D
D
D
D
D
D
D
D
D
D
D
D
D
D
D
D
D
"}
(10,1,3) = {"
D
D
D
D
D
D
D
D
D
D
D
D
D
D
D
D
D
D
D
D
D
D
D
D
D
D
D
D
D
D
D
"}
(11,1,3) = {"
D
D
D
D
D
D
D
D
D
D
D
D
D
D
D
D
D
D
D
D
D
D
D
D
D
D
D
D
D
D
D
"}
(12,1,3) = {"
D
D
D
D
D
D
D
D
D
D
D
D
D
D
D
D
D
D
D
D
D
D
D
D
D
D
D
D
D
D
D
"}
(13,1,3) = {"
D
D
D
D
D
D
D
D
D
D
D
D
D
D
D
D
D
D
D
D
D
D
D
D
D
D
D
D
D
D
D
"}
(14,1,3) = {"
D
D
D
D
D
D
D
D
D
D
D
D
D
D
D
D
D
D
D
D
D
D
D
D
D
D
D
D
D
D
D
"}
(15,1,3) = {"
D
D
D
D
D
D
D
D
D
D
D
D
D
D
D
D
D
D
D
D
D
D
D
D
D
D
D
D
D
D
D
"}
(16,1,3) = {"
D
D
D
D
D
D
D
D
D
D
D
D
D
D
D
D
D
D
D
D
D
D
D
D
D
D
D
D
D
D
D
"}
(17,1,3) = {"
D
D
D
D
D
D
D
D
D
D
D
D
D
D
D
D
D
D
D
D
D
D
D
D
D
D
D
D
D
D
D
"}
(18,1,3) = {"
D
D
D
D
D
D
D
D
D
D
D
D
D
D
D
D
D
D
D
D
D
D
D
D
D
D
D
D
D
D
D
"}
(19,1,3) = {"
D
D
D
D
D
D
D
D
D
D
D
D
D
D
D
D
D
D
D
D
D
D
D
D
D
D
D
D
D
D
D
"}
(20,1,3) = {"
D
D
D
D
D
D
D
D
D
D
D
D
D
D
D
D
D
D
D
D
D
D
D
D
D
D
D
D
D
D
D
"}
(21,1,3) = {"
D
D
D
D
D
D
D
D
D
D
D
D
D
D
D
D
D
D
D
D
D
D
D
D
D
D
D
D
D
D
D
"}
(22,1,3) = {"
D
D
D
D
D
D
D
D
D
D
D
D
D
D
D
D
D
D
D
D
D
D
D
D
D
D
D
D
D
D
D
"}
(23,1,3) = {"
D
D
D
D
D
D
D
D
D
D
D
D
D
D
D
D
D
D
D
D
D
D
D
D
D
D
D
D
D
D
D
"}
(24,1,3) = {"
D
D
D
D
D
D
D
D
D
D
D
D
D
D
D
D
D
D
D
D
D
D
D
D
D
D
D
D
D
D
D
"}
(25,1,3) = {"
D
D
D
D
D
D
D
D
D
D
D
D
D
D
D
D
D
D
D
D
D
D
D
D
D
D
D
D
D
D
D
"}
(26,1,3) = {"
D
D
D
D
D
D
D
D
D
D
D
D
D
D
D
D
D
D
D
D
D
D
D
D
D
D
D
D
D
D
D
"}
(27,1,3) = {"
D
D
D
D
D
D
D
D
D
D
D
D
D
D
D
D
D
D
D
D
D
D
D
D
D
D
D
D
D
D
D
"}
(28,1,3) = {"
D
D
D
D
D
D
D
D
D
D
D
D
D
D
D
D
D
D
D
D
D
D
D
D
D
D
D
D
D
D
D
"}
(29,1,3) = {"
D
D
D
D
D
D
D
D
D
D
D
D
D
D
D
D
D
D
D
D
D
D
D
D
D
D
D
D
D
D
D
"}
(30,1,3) = {"
D
D
D
D
D
D
D
D
D
D
D
D
D
D
D
D
D
D
D
D
D
D
D
D
D
D
D
D
D
D
D
"}
(31,1,3) = {"
D
D
D
D
D
D
D
D
D
D
D
D
D
D
D
D
D
D
D
D
D
D
D
D
D
D
D
D
D
D
D
"}
(32,1,3) = {"
D
D
D
D
D
D
D
D
D
D
D
D
D
D
D
D
D
D
D
D
D
D
D
D
D
D
D
D
D
D
D
"}
(33,1,3) = {"
D
D
D
D
D
D
D
D
D
D
D
D
D
D
D
D
D
D
D
D
D
D
D
D
D
D
D
D
D
D
D
"}
(34,1,3) = {"
D
D
D
D
D
D
D
D
D
D
D
D
D
D
D
D
D
D
D
D
D
D
D
D
D
D
D
D
D
D
D
"}
(35,1,3) = {"
D
D
D
D
D
D
D
D
D
D
D
D
D
D
D
D
D
D
D
D
D
D
D
D
D
D
D
D
D
D
D
"}
(36,1,3) = {"
D
D
D
D
D
D
D
D
D
D
D
D
D
D
D
D
D
D
D
D
D
D
D
D
D
D
D
D
D
D
D
"}
(37,1,3) = {"
D
D
D
D
D
D
D
D
D
D
D
D
D
D
D
D
D
D
D
D
D
D
D
D
D
D
D
D
D
D
D
"}
(38,1,3) = {"
D
D
D
D
D
D
D
D
D
D
D
D
D
D
D
D
D
D
D
D
D
D
D
D
D
D
D
D
D
D
D
"}
(39,1,3) = {"
D
D
D
D
D
D
D
D
D
D
D
D
D
D
D
D
D
D
D
D
D
D
D
D
D
D
D
D
D
D
D
"}
(40,1,3) = {"
D
D
D
D
D
D
D
D
D
D
D
D
D
D
D
D
D
D
D
D
D
D
D
D
D
D
D
D
D
D
D
"}
(41,1,3) = {"
D
D
D
D
D
D
D
D
D
D
D
D
D
D
D
D
D
D
D
D
D
D
D
D
D
D
D
D
D
D
D
"}
(42,1,3) = {"
D
D
D
D
D
D
D
D
D
D
D
D
D
D
D
D
D
D
D
D
D
D
D
D
D
D
D
D
D
D
D
"}
(43,1,3) = {"
D
D
D
D
D
D
D
D
D
D
D
D
D
D
D
D
D
D
D
D
D
D
D
D
D
D
D
D
D
D
D
"}
