"a" = (/turf/simulated/wall/silver,/area/interior/hyperloop)
"b" = (/obj/structure/bed/chair/shuttle,/obj/effect/floor_decal/corner_techfloor_grid/full{icon_state = "corner_techfloor_grid_full"; dir = 8},/turf/simulated/floor/tiled/monotile_dark,/area/interior/hyperloop)
"c" = (/obj/machinery/light/colored/blue{dir = 8},/obj/structure/table/reinforced,/obj/item/weapon/paper/crumpled,/obj/effect/floor_decal/corner_techfloor_grid{icon_state = "corner_techfloor_grid"; dir = 9},/turf/simulated/floor/tiled/monotile_dark,/area/interior/hyperloop)
"d" = (/obj/structure/vehicledoor,/turf/simulated/wall/silver,/area/interior/hyperloop)
"e" = (/obj/structure/neon_spline/blue{dir = 8; icon_state = "spline_fancy"},/obj/structure/neon_spline/blue{dir = 4; icon_state = "spline_fancy"},/turf/simulated/floor/tiled/techfloor,/area/interior/hyperloop)
"f" = (/obj/structure/bed/chair/shuttle{icon_state = "shuttle_chair"; dir = 1},/obj/effect/floor_decal/corner_techfloor_grid{icon_state = "corner_techfloor_grid"; dir = 9},/turf/simulated/floor/tiled/monotile_dark,/area/interior/hyperloop)
"g" = (/obj/structure/bed/chair/shuttle{icon_state = "shuttle_chair"; dir = 1},/turf/simulated/floor/tiled/monotile_dark,/area/interior/hyperloop)
"h" = (/obj/structure/bed/chair/shuttle,/obj/structure/window/reinforced{dir = 1},/turf/simulated/floor/tiled/monotile_dark,/area/interior/hyperloop)
"i" = (/obj/structure/table/reinforced,/turf/simulated/floor/tiled/monotile_dark,/area/interior/hyperloop)
"j" = (/obj/structure/window/reinforced{dir = 1},/obj/effect/floor_decal/corner_techfloor_grid{icon_state = "corner_techfloor_grid"; dir = 6},/obj/machinery/computer/shuttle_control/arrivals{dir = 8},/turf/simulated/floor/tiled/monotile_dark,/area/interior/hyperloop)
"k" = (/obj/machinery/light/colored/blue{dir = 8},/obj/structure/table/reinforced,/obj/item/weapon/paper,/obj/effect/floor_decal/corner_techfloor_grid{icon_state = "corner_techfloor_grid"; dir = 9},/turf/simulated/floor/tiled/monotile_dark,/area/interior/hyperloop)
"l" = (/obj/effect/vehicle_entrance,/obj/effect/floor_decal/corner_techfloor_grid{icon_state = "corner_techfloor_grid"; dir = 6},/turf/simulated/floor/tiled/monotile_dark,/area/interior/hyperloop)
"m" = (/obj/structure/bed/chair/shuttle{icon_state = "shuttle_chair"; dir = 1},/obj/effect/floor_decal/corner_techfloor_grid{icon_state = "corner_techfloor_grid"; dir = 6},/turf/simulated/floor/tiled/monotile_dark,/area/interior/hyperloop)
"n" = (/obj/machinery/light/colored/blue{dir = 4; tag = null},/obj/structure/table/reinforced,/obj/item/weapon/storage/box/donut/empty,/obj/effect/floor_decal/corner_techfloor_grid{icon_state = "corner_techfloor_grid"; dir = 6},/turf/simulated/floor/tiled/monotile_dark,/area/interior/hyperloop)
"o" = (/obj/structure/bed/chair/shuttle,/obj/effect/floor_decal/corner_techfloor_grid{icon_state = "corner_techfloor_grid"; dir = 5},/obj/machinery/arrival_status_display{pixel_y = 28; pixel_x = 17},/turf/simulated/floor/tiled/monotile_dark,/area/interior/hyperloop)
"q" = (/obj/structure/table/reinforced,/obj/item/weapon/paper,/turf/simulated/floor/tiled/monotile_dark,/area/interior/hyperloop)
"r" = (/obj/machinery/light/colored/blue{dir = 1},/obj/effect/floor_decal/corner_techfloor_grid/full{icon_state = "corner_techfloor_grid_full"; dir = 1},/turf/simulated/floor/tiled/monotile_dark,/area/interior/hyperloop)
"s" = (/obj/machinery/light/colored/blue{dir = 8},/obj/structure/table/reinforced,/obj/item/trash/raisins,/obj/effect/floor_decal/corner_techfloor_grid{icon_state = "corner_techfloor_grid"; dir = 9},/turf/simulated/floor/tiled/monotile_dark,/area/interior/hyperloop)
"u" = (/obj/structure/neon_spline/blue{dir = 8; icon_state = "spline_fancy"},/obj/structure/neon_spline/blue{dir = 4; icon_state = "spline_fancy"},/obj/effect/floor_decal/corner_techfloor_grid{icon_state = "corner_techfloor_grid"; dir = 10},/turf/simulated/floor/tiled/techfloor,/area/interior/hyperloop)
"v" = (/turf/simulated/floor/tiled/monotile_dark,/area/interior/hyperloop)
"w" = (/obj/structure/bed/chair/shuttle{icon_state = "shuttle_chair"; dir = 4},/turf/simulated/floor/tiled/monotile_dark,/area/interior/hyperloop)
"x" = (/obj/structure/bed/chair/shuttle{icon_state = "shuttle_chair"; dir = 1},/obj/effect/floor_decal/corner_techfloor_grid/full{icon_state = "corner_techfloor_grid_full"; dir = 4},/turf/simulated/floor/tiled/monotile_dark,/area/interior/hyperloop)
"y" = (/obj/structure/bed/chair/shuttle{icon_state = "shuttle_chair"; dir = 1},/obj/effect/floor_decal/corner_techfloor_grid{icon_state = "corner_techfloor_grid"; dir = 10},/obj/machinery/arrival_status_display{pixel_x = 17; pixel_y = -25},/turf/simulated/floor/tiled/monotile_dark,/area/interior/hyperloop)
"z" = (/obj/machinery/light/colored/blue{dir = 4; tag = null},/obj/structure/table/reinforced,/obj/item/weapon/newspaper,/obj/effect/floor_decal/corner_techfloor_grid{icon_state = "corner_techfloor_grid"; dir = 6},/turf/simulated/floor/tiled/monotile_dark,/area/interior/hyperloop)
"A" = (/obj/structure/bed/chair/shuttle,/obj/structure/window/reinforced{dir = 1},/obj/effect/floor_decal/corner_techfloor_grid{icon_state = "corner_techfloor_grid"; dir = 6},/turf/simulated/floor/tiled/monotile_dark,/area/interior/hyperloop)
"B" = (/obj/structure/bed/chair/shuttle,/obj/structure/window/reinforced{dir = 1},/obj/effect/floor_decal/corner_techfloor_grid{icon_state = "corner_techfloor_grid"; dir = 9},/turf/simulated/floor/tiled/monotile_dark,/area/interior/hyperloop)
"D" = (/obj/structure/table/reinforced,/obj/item/trash/plate,/turf/simulated/floor/tiled/monotile_dark,/area/interior/hyperloop)
"E" = (/obj/effect/floor_decal/corner_techfloor_grid{icon_state = "corner_techfloor_grid"; dir = 6},/obj/machinery/computer/shuttle_control/arrivals{dir = 8},/turf/simulated/floor/tiled/monotile_dark,/area/interior/hyperloop)
"F" = (/obj/structure/bed/chair/shuttle{icon_state = "shuttle_chair"; dir = 1},/obj/effect/floor_decal/corner_techfloor_grid/full,/turf/simulated/floor/tiled/monotile_dark,/area/interior/hyperloop)
"G" = (/obj/machinery/light/colored/blue{dir = 8},/obj/structure/table/reinforced,/obj/item/trash/candy,/obj/effect/floor_decal/corner_techfloor_grid{icon_state = "corner_techfloor_grid"; dir = 9},/turf/simulated/floor/tiled/monotile_dark,/area/interior/hyperloop)
"H" = (/obj/effect/floor_decal/corner_techfloor_grid{icon_state = "corner_techfloor_grid"; dir = 10},/turf/simulated/floor/tiled/monotile_dark,/area/interior/hyperloop)
"I" = (/obj/structure/neon_spline/blue{dir = 8; icon_state = "spline_fancy"},/obj/structure/neon_spline/blue{dir = 4; icon_state = "spline_fancy"},/obj/structure/curtain/open/color/pale_blue,/turf/simulated/floor/tiled/techfloor/grid,/area/interior/hyperloop)
"J" = (/obj/structure/neon_spline/blue{dir = 8; icon_state = "spline_fancy"},/obj/structure/neon_spline/blue{dir = 4; icon_state = "spline_fancy"},/obj/effect/floor_decal/corner_techfloor_grid{icon_state = "corner_techfloor_grid"; dir = 5},/turf/simulated/floor/tiled/techfloor,/area/interior/hyperloop)
"M" = (/obj/structure/window/reinforced{dir = 1},/obj/structure/bed/chair/shuttle{icon_state = "shuttle_chair"; dir = 4},/turf/simulated/floor/tiled/monotile_dark,/area/interior/hyperloop)
"N" = (/obj/machinery/light/colored/blue,/obj/effect/floor_decal/corner_techfloor_grid/full{icon_state = "corner_techfloor_grid_full"; dir = 4},/turf/simulated/floor/tiled/monotile_dark,/area/interior/hyperloop)
"O" = (/obj/machinery/light/colored/blue{dir = 4; tag = null},/obj/structure/table/reinforced,/obj/effect/floor_decal/corner_techfloor_grid{icon_state = "corner_techfloor_grid"; dir = 6},/turf/simulated/floor/tiled/monotile_dark,/area/interior/hyperloop)
"P" = (/obj/machinery/light/colored/blue{dir = 8},/obj/structure/table/reinforced,/obj/effect/floor_decal/corner_techfloor_grid{icon_state = "corner_techfloor_grid"; dir = 9},/turf/simulated/floor/tiled/monotile_dark,/area/interior/hyperloop)
"Q" = (/obj/structure/neon_spline/blue/cee,/turf/simulated/floor/tiled/techfloor,/area/interior/hyperloop)
"R" = (/obj/structure/bed/chair/shuttle{icon_state = "shuttle_chair"; dir = 1},/obj/effect/floor_decal/corner_techfloor_grid{icon_state = "corner_techfloor_grid"; dir = 10},/turf/simulated/floor/tiled/monotile_dark,/area/interior/hyperloop)
"S" = (/obj/structure/neon_spline/blue/cee{dir = 1},/turf/simulated/floor/tiled/techfloor,/area/interior/hyperloop)
"T" = (/obj/machinery/light/colored/blue{dir = 8},/obj/structure/table/reinforced,/obj/item/weapon/newspaper,/obj/effect/floor_decal/corner_techfloor_grid{icon_state = "corner_techfloor_grid"; dir = 9},/turf/simulated/floor/tiled/monotile_dark,/area/interior/hyperloop)
"U" = (/obj/effect/floor_decal/corner_techfloor_grid{icon_state = "corner_techfloor_grid"; dir = 5},/turf/simulated/floor/tiled/monotile_dark,/area/interior/hyperloop)
"V" = (/obj/structure/table/reinforced,/obj/item/weapon/paper/crumpled,/turf/simulated/floor/tiled/monotile_dark,/area/interior/hyperloop)
"X" = (/obj/structure/bed/chair/shuttle,/obj/effect/floor_decal/corner_techfloor_grid/full{icon_state = "corner_techfloor_grid_full"; dir = 1},/turf/simulated/floor/tiled/monotile_dark,/area/interior/hyperloop)
"Y" = (/obj/structure/bed/chair/shuttle,/obj/effect/floor_decal/corner_techfloor_grid{icon_state = "corner_techfloor_grid"; dir = 5},/obj/machinery/status_display,/turf/simulated/floor/tiled/monotile_dark,/area/interior/hyperloop)

(1,1,1) = {"
aaaaaaa
aboUUra
aGivvld
afgSwEa
aBhehAa
aTieiOa
afgegma
aBhehAa
aPqeiza
aFRuRxa
aaaIaaa
abYJYXa
acieVna
afgegma
aBhehAa
asieDza
afgegma
aBheMja
akiQvld
aFyHHNa
aaaaaaa
"}
