"a" = (/obj/machinery/atmospherics/pipe/zpipe/up{icon_state = "up"; dir = 4},/obj/structure/disposalpipe/up,/turf/simulated/floor/tiled/dark,/area/aisat)
"b" = (/turf/simulated/wall,/area/aisat)
"c" = (/obj/structure/disposalpipe/segment,/turf/simulated/floor/tiled/dark,/area/aisat)
"d" = (/obj/machinery/atmospherics/pipe/simple/visible{dir = 4},/obj/effect/floor_decal/corner/white/diagonal,/turf/simulated/floor/tiled/dark,/area/aisat)
"e" = (/obj/machinery/atmospherics/pipe/manifold/visible{dir = 1},/obj/effect/floor_decal/corner/white/diagonal,/turf/simulated/floor/tiled/dark,/area/aisat)
"f" = (/obj/machinery/atmospherics/binary/pump/high_power{dir = 8},/obj/effect/floor_decal/corner/white/diagonal,/turf/simulated/floor/tiled/dark,/area/aisat)
"g" = (/obj/machinery/atmospherics/pipe/simple/visible{icon_state = "intact"; dir = 10},/obj/effect/floor_decal/corner/white/diagonal,/turf/simulated/floor/tiled/dark,/area/aisat)
"h" = (/obj/effect/floor_decal/corner/white/diagonal,/turf/simulated/floor/tiled/dark,/area/aisat)
"i" = (/obj/machinery/light{dir = 1},/turf/simulated/floor/tiled/dark,/area/aisat)
"j" = (/obj/machinery/light_switch,/turf/simulated/floor/tiled/dark,/area/aisat)
"k" = (/obj/machinery/atmospherics/pipe/simple/visible,/obj/effect/floor_decal/corner/white/diagonal,/obj/machinery/meter,/turf/simulated/floor/tiled/dark,/area/aisat)
"l" = (/obj/machinery/atmospherics/portables_connector{dir = 4},/obj/effect/floor_decal/corner/white/diagonal,/turf/simulated/floor/tiled/dark,/area/aisat)
"m" = (/obj/machinery/atmospherics/pipe/manifold/visible{icon_state = "map"; dir = 4},/obj/effect/floor_decal/corner/white/diagonal,/obj/machinery/meter,/turf/simulated/floor/tiled/dark,/area/aisat)
"n" = (/turf/simulated/floor/tiled/dark,/area/aisat)
"o" = (/obj/effect/floor_decal/industrial/hatch/yellow,/turf/simulated/floor/tiled/dark,/area/aisat)
"p" = (/obj/machinery/light{icon_state = "tube1"; dir = 4},/obj/machinery/power/apc{dir = 4; name = "east bump"; pixel_x = 24},/turf/simulated/floor/tiled/dark,/area/aisat)
"q" = (/obj/machinery/atmospherics/pipe/simple/visible{icon_state = "intact"; dir = 5},/obj/effect/floor_decal/corner/white/diagonal,/turf/simulated/floor/tiled/dark,/area/aisat)
"r" = (/obj/machinery/atmospherics/binary/pump/high_power{icon_state = "map_off"; dir = 4},/obj/effect/floor_decal/corner/white/diagonal,/turf/simulated/floor/tiled/dark,/area/aisat)
"s" = (/obj/machinery/atmospherics/pipe/simple/visible{icon_state = "intact"; dir = 9},/obj/effect/floor_decal/corner/white/diagonal,/turf/simulated/floor/tiled/dark,/area/aisat)
"t" = (/obj/structure/ladder/up,/turf/simulated/floor/tiled/dark,/area/aisat)
"u" = (/obj/structure/neon_spline/green{icon_state = "spline_fancy"; dir = 9},/turf/simulated/floor/tiled/dark,/area/aisat)
"v" = (/obj/machinery/light,/turf/simulated/floor/tiled/dark,/area/aisat)
"w" = (/obj/machinery/light{icon_state = "tube1"; dir = 8},/obj/machinery/disposal,/obj/structure/disposalpipe/trunk{icon_state = "pipe-t"; dir = 1},/turf/simulated/floor/tiled/dark,/area/aisat)
"x" = (/obj/machinery/light{icon_state = "tube1"; dir = 4},/turf/simulated/floor/tiled/dark,/area/aisat)
"y" = (/obj/structure/neon_spline/green{icon_state = "spline_fancy"; dir = 1},/turf/simulated/floor/tiled/dark,/area/aisat)
"z" = (/obj/machinery/light{icon_state = "tube1"; dir = 8},/turf/simulated/floor/tiled/dark,/area/aisat)
"A" = (/obj/structure/neon_spline/green{icon_state = "spline_fancy"; dir = 5},/turf/simulated/floor/tiled/dark,/area/aisat)
"B" = (/obj/effect/floor_decal/corner/white/diagonal,/obj/structure/table/standard,/obj/item/device/multitool,/turf/simulated/floor/tiled/dark,/area/aisat)
"C" = (/obj/machinery/light{dir = 1},/obj/structure/table/standard,/obj/item/weapon/storage/belt/utility/full,/turf/simulated/floor/tiled/dark,/area/aisat)
"D" = (/obj/effect/floor_decal/corner/white/diagonal,/obj/structure/table/standard,/obj/item/clothing/gloves/yellow,/turf/simulated/floor/tiled/dark,/area/aisat)
"E" = (/obj/structure/neon_spline/green{icon_state = "spline_fancy"; dir = 8},/turf/simulated/floor/tiled/dark,/area/aisat)
"F" = (/obj/effect/landmark{name = "JoinLate"},/obj/effect/floor_decal/corner/white/diagonal,/turf/simulated/floor/tiled/dark,/area/aisat)
"G" = (/obj/effect/landmark/start,/turf/simulated/floor/tiled/dark,/area/aisat)
"H" = (/obj/structure/neon_spline/green{icon_state = "spline_fancy"; dir = 4},/turf/simulated/floor/tiled/dark,/area/aisat)
"I" = (/obj/structure/neon_spline/green{icon_state = "spline_fancy"; dir = 10},/turf/simulated/floor/tiled/dark,/area/aisat)
"J" = (/obj/effect/floor_decal/sign/a,/turf/simulated/floor/tiled/dark,/area/aisat)
"K" = (/obj/machinery/light,/obj/effect/floor_decal/corner/white/diagonal,/turf/simulated/floor/tiled/dark,/area/aisat)
"L" = (/obj/structure/neon_spline/green,/turf/simulated/floor/tiled/dark,/area/aisat)
"M" = (/obj/structure/neon_spline/green{icon_state = "spline_fancy"; dir = 6},/turf/simulated/floor/tiled/dark,/area/aisat)
"N" = (/obj/effect/floor_decal/corner/white/diagonal,/mob/living/carbon/human/npc/interactable/retail/testing,/turf/simulated/floor/tiled/dark,/area/aisat)
"O" = (/obj/effect/floor_decal/corner/white/diagonal,/obj/structure/table/standard,/obj/item/weapon/spacecash/bundle/c100,/obj/item/weapon/spacecash/bundle/c100,/turf/simulated/floor/tiled/dark,/area/aisat)
"P" = (/obj/effect/floor_decal/corner/white/diagonal,/obj/structure/table/standard,/obj/item/weapon/surgical/scalpel,/obj/item/weapon/surgical/retractor,/obj/item/weapon/surgical/hemostat,/obj/item/weapon/surgical/circular_saw,/obj/item/weapon/surgical/cautery,/obj/item/weapon/surgical/bonesetter,/obj/item/weapon/surgical/bonegel,/obj/item/weapon/surgical/bone_clamp,/obj/item/weapon/surgical/suture,/obj/item/weapon/surgical/surgicaldrill,/turf/simulated/floor/tiled/dark,/area/aisat)
"R" = (/obj/effect/floor_decal/corner/white/diagonal,/obj/structure/table/standard,/turf/simulated/floor/tiled/dark,/area/aisat)
"S" = (/obj/effect/floor_decal/corner/white/diagonal,/obj/structure/table/standard,/obj/machinery/monitor,/turf/simulated/floor/tiled/dark,/area/aisat)
"T" = (/obj/structure/bed/roller/adv,/turf/simulated/floor/tiled/dark,/area/aisat)

(1,1,1) = {"
bbbbbbbbbbbbbbbbbbbbbbbbbbbbbbbb
bnnnnnnnnnnnnnnnnnnnnnnnnnnnnnnb
bnuyyyyyyyyyyyyyyyyyyyyyyyyyyAnb
bnEnnnnnnnnnnnnnnnnnnnnnnnnnnHnb
bnEnnnnnnnnnnnnnnnnnnnnnnnnnnHnb
bnEnnnnnnnnnnnnnnnnnnnnnnnnnnHnb
bnEnnnnnnnnnnnnnnnnnnnnnnnnnnHnb
bnEnnnnnnnnnnnnnnnnnnnnnnnnnnHnb
bnEnnnnnnnnnnnnnnnnnnnnnnnnnnHnb
bnEnnnnnnnnnnnnnnnnnnnnnnnnnnHnb
bnEnnnnnnadefghihhhhhhnnnnnnnHnb
bnEnnnnnnchklmhnhhooohnnnnnnnHnb
bnEnnnnnnhhqrshthhooohnnnnnnnHnb
bnEnnnnnnhhhhhhnhhooohnnnnnnnHnb
bnEnnnnnnhhhNhhnhhhhhhnnnnnnnHnb
bnEnnnnnnhhORRhvhhhhhhnnnnnnnHnb
bnEnnnnnnwnnnnxjznnnnpnnnnnnnHnb
bnEnnnnnnhhhhhBCDhhhhhnnnnnnnHnb
bnEnnnnnnhhFFFhnhhPRShnnnnnnnHnb
bnEnnnnnnhhFFFhGhhhThhnnnnnnnHnb
bnEnnnnnnhhFFFhnhhhhhhnnnnnnnHnb
bnEnnnnnnhhhhhhJhhhhhhnnnnnnnHnb
bnEnnnnnnhhhKhhnhhhhhhnnnnnnnHnb
bnEnnnnnnnnnnnnnnnnnnnnnnnnnnHnb
bnEnnnnnnnnnnnnnnnnnnnnnnnnnnHnb
bnEnnnnnnnnnnnnnnnnnnnnnnnnnnHnb
bnEnnnnnnnnnnnnnnnnnnnnnnnnnnHnb
bnEnnnnnnnnnnnnnnnnnnnnnnnnnnHnb
bnEnnnnnnnnnnnnnnnnnnnnnnnnnnHnb
bnILLLLLLLLLLLLLLLLLLLLLLLLLLMnb
bnnnnnnnnnnnnnnnnnnnnnnnnnnnnnnb
bbbbbbbbbbbbbbbbbbbbbbbbbbbbbbbb
"}
