"aa" = (/obj/machinery/atmospherics/pipe/zpipe/up{icon_state = "up"; dir = 4},/obj/structure/disposalpipe/up,/turf/simulated/floor/tiled/dark,/area/aisat)
"ab" = (/turf/simulated/wall,/area/aisat)
"ac" = (/obj/structure/disposalpipe/segment,/turf/simulated/floor/tiled/dark,/area/aisat)
"ad" = (/obj/machinery/atmospherics/pipe/simple/visible{dir = 4},/obj/effect/floor_decal/corner/white/diagonal,/turf/simulated/floor/tiled/dark,/area/aisat)
"ae" = (/obj/machinery/atmospherics/pipe/manifold/visible{dir = 1},/obj/effect/floor_decal/corner/white/diagonal,/turf/simulated/floor/tiled/dark,/area/aisat)
"af" = (/obj/machinery/atmospherics/binary/pump/high_power{dir = 8},/obj/effect/floor_decal/corner/white/diagonal,/turf/simulated/floor/tiled/dark,/area/aisat)
"ag" = (/obj/machinery/atmospherics/pipe/simple/visible{icon_state = "intact"; dir = 10},/obj/effect/floor_decal/corner/white/diagonal,/turf/simulated/floor/tiled/dark,/area/aisat)
"ah" = (/obj/effect/floor_decal/corner/white/diagonal,/turf/simulated/floor/tiled/dark,/area/aisat)
"ai" = (/obj/machinery/light{dir = 1},/turf/simulated/floor/tiled/dark,/area/aisat)
"aj" = (/obj/machinery/light_switch,/turf/simulated/floor/tiled/dark,/area/aisat)
"ak" = (/obj/machinery/atmospherics/pipe/simple/visible,/obj/effect/floor_decal/corner/white/diagonal,/obj/machinery/meter,/turf/simulated/floor/tiled/dark,/area/aisat)
"al" = (/obj/machinery/atmospherics/portables_connector{dir = 4},/obj/effect/floor_decal/corner/white/diagonal,/turf/simulated/floor/tiled/dark,/area/aisat)
"am" = (/obj/machinery/atmospherics/pipe/manifold/visible{icon_state = "map"; dir = 4},/obj/effect/floor_decal/corner/white/diagonal,/obj/machinery/meter,/turf/simulated/floor/tiled/dark,/area/aisat)
"an" = (/turf/simulated/floor/tiled/dark,/area/aisat)
"ao" = (/obj/effect/floor_decal/industrial/hatch/yellow,/turf/simulated/floor/tiled/dark,/area/aisat)
"ap" = (/obj/machinery/light{icon_state = "tube1"; dir = 4},/obj/machinery/power/apc{dir = 4; name = "east bump"; pixel_x = 24},/turf/simulated/floor/tiled/dark,/area/aisat)
"aq" = (/obj/machinery/atmospherics/pipe/simple/visible{icon_state = "intact"; dir = 5},/obj/effect/floor_decal/corner/white/diagonal,/turf/simulated/floor/tiled/dark,/area/aisat)
"ar" = (/obj/machinery/atmospherics/binary/pump/high_power{icon_state = "map_off"; dir = 4},/obj/effect/floor_decal/corner/white/diagonal,/turf/simulated/floor/tiled/dark,/area/aisat)
"as" = (/obj/machinery/atmospherics/pipe/simple/visible{icon_state = "intact"; dir = 9},/obj/effect/floor_decal/corner/white/diagonal,/turf/simulated/floor/tiled/dark,/area/aisat)
"at" = (/obj/structure/ladder/up,/turf/simulated/floor/tiled/dark,/area/aisat)
"au" = (/obj/structure/neon_spline/green{icon_state = "spline_fancy"; dir = 9},/obj/structure/neon_spline/red/corner,/turf/simulated/floor/tiled/dark,/area/aisat)
"av" = (/obj/machinery/light,/turf/simulated/floor/tiled/dark,/area/aisat)
"aw" = (/obj/machinery/light{icon_state = "tube1"; dir = 8},/obj/machinery/disposal,/obj/structure/disposalpipe/trunk{icon_state = "pipe-t"; dir = 1},/turf/simulated/floor/tiled/dark,/area/aisat)
"ax" = (/obj/machinery/light{icon_state = "tube1"; dir = 4},/turf/simulated/floor/tiled/dark,/area/aisat)
"ay" = (/obj/structure/neon_spline/green{icon_state = "spline_fancy"; dir = 1},/obj/structure/neon_spline/red,/turf/simulated/floor/tiled/dark,/area/aisat)
"az" = (/obj/machinery/light{icon_state = "tube1"; dir = 8},/turf/simulated/floor/tiled/dark,/area/aisat)
"aA" = (/obj/structure/neon_spline/green{icon_state = "spline_fancy"; dir = 5},/obj/structure/neon_spline/red/corner{icon_state = "spline_fancy_corner"; dir = 8},/turf/simulated/floor/tiled/dark,/area/aisat)
"aB" = (/obj/effect/floor_decal/corner/white/diagonal,/obj/structure/table/standard,/obj/item/device/multitool,/turf/simulated/floor/tiled/dark,/area/aisat)
"aC" = (/obj/machinery/light{dir = 1},/obj/structure/table/standard,/obj/item/weapon/storage/belt/utility/full,/turf/simulated/floor/tiled/dark,/area/aisat)
"aD" = (/obj/effect/floor_decal/corner/white/diagonal,/obj/structure/table/standard,/obj/item/clothing/gloves/yellow,/turf/simulated/floor/tiled/dark,/area/aisat)
"aE" = (/obj/structure/neon_spline/green{icon_state = "spline_fancy"; dir = 8},/obj/structure/neon_spline/red{icon_state = "spline_fancy"; dir = 4},/turf/simulated/floor/tiled/dark,/area/aisat)
"aF" = (/obj/effect/landmark{name = "JoinLate"},/obj/effect/floor_decal/corner/white/diagonal,/turf/simulated/floor/tiled/dark,/area/aisat)
"aG" = (/obj/effect/landmark/start,/turf/simulated/floor/tiled/dark,/area/aisat)
"aH" = (/obj/structure/neon_spline/green{icon_state = "spline_fancy"; dir = 4},/obj/structure/neon_spline/red{icon_state = "spline_fancy"; dir = 8},/turf/simulated/floor/tiled/dark,/area/aisat)
"aI" = (/obj/structure/neon_spline/green{icon_state = "spline_fancy"; dir = 10},/obj/structure/neon_spline/red/corner{icon_state = "spline_fancy_corner"; dir = 1},/turf/simulated/floor/tiled/dark,/area/aisat)
"aJ" = (/obj/effect/floor_decal/sign/a,/turf/simulated/floor/tiled/dark,/area/aisat)
"aK" = (/obj/machinery/light,/obj/effect/floor_decal/corner/white/diagonal,/turf/simulated/floor/tiled/dark,/area/aisat)
"aL" = (/obj/structure/neon_spline/green,/obj/structure/neon_spline/red{icon_state = "spline_fancy"; dir = 1},/turf/simulated/floor/tiled/dark,/area/aisat)
"aM" = (/obj/structure/neon_spline/green{icon_state = "spline_fancy"; dir = 6},/obj/structure/neon_spline/red/corner{icon_state = "spline_fancy_corner"; dir = 4},/turf/simulated/floor/tiled/dark,/area/aisat)
"aN" = (/obj/effect/floor_decal/corner/white/diagonal,/mob/living/carbon/human/npc/interactable/retail/testing,/turf/simulated/floor/tiled/dark,/area/aisat)
"aO" = (/obj/effect/floor_decal/corner/white/diagonal,/obj/structure/table/standard,/obj/item/weapon/spacecash/bundle/c100,/obj/item/weapon/spacecash/bundle/c100,/turf/simulated/floor/tiled/dark,/area/aisat)
"aP" = (/obj/effect/floor_decal/corner/white/diagonal,/obj/structure/table/standard,/obj/item/weapon/surgical/scalpel,/obj/item/weapon/surgical/retractor,/obj/item/weapon/surgical/hemostat,/obj/item/weapon/surgical/circular_saw,/obj/item/weapon/surgical/cautery,/obj/item/weapon/surgical/bonesetter,/obj/item/weapon/surgical/bonegel,/obj/item/weapon/surgical/bone_clamp,/obj/item/weapon/surgical/suture,/obj/item/weapon/surgical/surgicaldrill,/turf/simulated/floor/tiled/dark,/area/aisat)
"aQ" = (/obj/effect/floor_decal/corner/white/diagonal,/obj/machinery/atm,/turf/simulated/floor/tiled/dark,/area/aisat)
"aR" = (/obj/effect/floor_decal/corner/white/diagonal,/obj/structure/table/standard,/turf/simulated/floor/tiled/dark,/area/aisat)
"aS" = (/obj/effect/floor_decal/corner/white/diagonal,/obj/structure/table/standard,/obj/machinery/monitor,/turf/simulated/floor/tiled/dark,/area/aisat)
"aT" = (/obj/structure/bed/roller/adv,/turf/simulated/floor/tiled/dark,/area/aisat)
"aU" = (/obj/effect/floor_decal/corner/white/diagonal,/obj/structure/table/standard,/obj/item/weapon/paper_bin,/turf/simulated/floor/tiled/dark,/area/aisat)
"aV" = (/obj/effect/floor_decal/corner/white/diagonal,/obj/structure/table/standard,/obj/item/weapon/pen/red,/turf/simulated/floor/tiled/dark,/area/aisat)
"aW" = (/turf/simulated/wall,/area/example_mine_lift)
"aX" = (/obj/effect/floor_decal/corner/white/diagonal,/obj/structure/table/standard,/obj/item/weapon/card/id/security/detective,/turf/simulated/floor/tiled/dark,/area/aisat)
"aY" = (/obj/machinery/door/airlock,/turf/simulated/floor/tiled/dark,/area/example_mine_lift)
"aZ" = (/obj/machinery/mine_lift_button{pixel_x = -24},/turf/simulated/floor/tiled/dark,/area/example_mine_lift)
"ba" = (/turf/simulated/floor/tiled/dark,/area/example_mine_lift)

(1,1,1) = {"
abababababababababababababababababababababababababababababababab
abananananananananananananananananananananananananananananananab
abanauayayayayayayayayayayayayayayayayayayayayayayayayayayaAanab
abanaEananananananananananananananananananananananananananaHanab
abanaEananananananananananananananananananananananananananaHanab
abanaEananananananananananananananananananananananananananaHanab
abanaEananananananananananananananananananananananananananaHanab
abanaEananananananananananananananananananananananananananaHanab
abanaEananananananananananananananananananananananananananaHanab
abanaEananananananananananananananananananananananananananaHanab
abanaEananananananaaadaeafagahaiahahahahahahanananananananaHanab
abanaEananananananacahakalamahanahahaoaoaoahanananananananaHanab
abanaEananananananahahaqarasahatahahaoaoaoahanananananananaHanab
abanaEananananananahahahahahahanahahaoaoaoahanananananananaHanab
abanaEananananananahahahaNahahanahahahahahahanananananananaHanab
abanaEananananananahahaOaRaXaQavahahahahahahanananananananaHanab
abanaEananananananawananananaxajazananananapanananananananaHanab
abanaEananananananahahahahahaBaCaDahahahahahanananananananaHanab
abanaEananananananaUahaFaFaFahanahahaPaRaSahanananananananaHanab
abanaEananananananaVahaFaFaFahaGahahahaTahahanananananananaHanab
abanaEananananananaRahaFaFaFahanahahahahahahanananananananaHanab
abanaEananananananahahahahahahaJahahahahahahanananananananaHanab
abanaEananananananahahahaKahahanahahahahahahanananananananaHanab
abanaEananananananananananananananananananananananananananaHanab
abanaEanananananananananananananananananananananaWaYaYaWanaHanab
abanaEanananananananananananananananananananananaWaZbaaWanaHanab
abanaEanananananananananananananananananananananaWbabaaWanaHanab
abanaEanananananananananananananananananananananaWaWaWaWanaHanab
abanaEananananananananananananananananananananananananananaHanab
abanaIaLaLaLaLaLaLaLaLaLaLaLaLaLaLaLaLaLaLaLaLaLaLaLaLaLaLaManab
abananananananananananananananananananananananananananananananab
abababababababababababababababababababababababababababababababab
"}
