"aZ" = (/obj/structure/bed/chair/sofa/black,/turf/simulated/floor/carpet/bcarpet,/area/space)
"bi" = (/obj/structure/neon_spline/orange,/obj/structure/neon_spline/orange{dir = 1},/obj/structure/window/reinforced,/obj/machinery/light/colored{dir = 8},/obj/item/device/flashlight/lamp/alt_2{pixel_y = 6},/turf/simulated/floor/tiled/dark,/area/space)
"bU" = (/obj/structure/closet/secure_closet/freezer{name = "fridge"},/obj/effect/floor_decal/corner/black/border{dir = 6},/obj/effect/floor_decal/corner/black{dir = 1},/obj/machinery/light/colored,/turf/simulated/floor/tiled/white,/area/space)
"cO" = (/obj/structure/railing{dir = 8; icon_state = "railing0"; tag = "icon-railing0 (WEST)"},/obj/effect/floor_decal/corner/red/border{dir = 8; icon_state = "bordercolor"},/obj/structure/neon_spline/red{dir = 8},/turf/simulated/floor/tiled/monotile,/area/space)
"dL" = (/obj/machinery/cooker/oven{pixel_x = -3},/obj/effect/floor_decal/corner/black/border{dir = 10},/turf/simulated/floor/tiled/white,/area/space)
"fo" = (/obj/machinery/door/unpowered/manhattan/wood/north,/turf/simulated/floor/tiled/monotile_dark,/area/space)
"fC" = (/obj/structure/bed/chair/sofa/black/corner{dir = 1; icon_state = "sofacorner"},/turf/simulated/floor/carpet/bcarpet,/area/space)
"hp" = (/obj/structure/neon_spline/orange{dir = 1},/obj/effect/floor_decal/corner/red{dir = 5},/obj/structure/closet/crate/secure/bin,/turf/simulated/floor/tiled/dark,/area/space)
"hJ" = (/obj/structure/railing{dir = 4; icon_state = "railing0"; tag = "icon-railing0 (EAST)"},/obj/structure/flora/pottedplant/pinksakura,/obj/effect/floor_decal/corner/red/border{dir = 4; icon_state = "bordercolor"},/obj/structure/neon_spline/red{dir = 4},/turf/simulated/floor/tiled/monotile,/area/space)
"hP" = (/obj/structure/bookcase/manuals,/turf/simulated/floor/wood/walnut,/area/space)
"iS" = (/obj/machinery/light_switch{pixel_x = 28},/obj/structure/neon_spline/orange{dir = 4},/obj/effect/floor_decal/corner/red{dir = 6},/turf/simulated/floor/tiled/dark,/area/space)
"je" = (/obj/machinery/door/unpowered/manhattan/steel/north,/turf/simulated/floor/tiled/monotile_dark,/area/space)
"jo" = (/obj/structure/bed/chair/sofa/black/left,/turf/simulated/floor/carpet/bcarpet,/area/space)
"jw" = (/obj/effect/floor_decal/corner/paleblue{dir = 5},/obj/structure/neon_spline/lightblue{dir = 1},/turf/simulated/floor/tiled/white,/area/space)
"jy" = (/obj/structure/curtain/open/shower,/obj/machinery/shower{dir = 8; pixel_x = 5},/turf/simulated/floor/tiled/white,/area/space)
"jB" = (/obj/machinery/light_switch{dir = 4; override_automatic_dir_pixel_offset = 1; pixel_x = -27; pixel_y = -8},/obj/structure/closet/cabinet,/turf/simulated/floor/wood/walnut,/area/space)
"kF" = (/obj/effect/floor_decal/corner/black/diagonal,/turf/simulated/floor/tiled/white,/area/space)
"lU" = (/obj/structure/neon_spline/orange{dir = 8},/turf/simulated/floor/tiled/dark,/area/space)
"nf" = (/turf/simulated/open,/area/space)
"qU" = (/turf/simulated/wall/concrete,/area/space)
"sq" = (/obj/structure/neon_spline/orange/corner{dir = 1},/obj/effect/floor_decal/corner/red{dir = 4},/turf/simulated/floor/tiled/dark,/area/space)
"sv" = (/obj/structure/bed/wood,/turf/simulated/floor/wood/walnut,/area/space)
"sw" = (/obj/structure/neon_spline/orange{dir = 4},/obj/effect/floor_decal/corner/red{dir = 6},/turf/simulated/floor/tiled/dark,/area/space)
"tK" = (/obj/structure/undies_wardrobe{pixel_x = 6},/obj/item/device/flashlight/lamp/alt_2{pixel_x = 9; pixel_y = 16},/turf/simulated/floor/wood/walnut,/area/space)
"vf" = (/obj/structure/bed/chair/wood{dir = 8},/obj/effect/floor_decal/corner/red{dir = 5},/turf/simulated/floor/tiled,/area/space)
"vg" = (/obj/structure/table/home_wooden/low,/obj/item/weapon/reagent_containers/food/drinks/teapot{pixel_y = 6},/turf/simulated/floor/carpet/bcarpet,/area/space)
"vm" = (/obj/structure/noticeboard{pixel_y = 28},/turf/simulated/floor/wood/walnut,/area/space)
"wc" = (/obj/structure/mirror/wide{pixel_y = 32},/obj/structure/table/marble,/obj/structure/sink/modern,/obj/effect/floor_decal/corner/paleblue{dir = 5},/obj/structure/neon_spline/lightblue{dir = 1},/turf/simulated/floor/tiled/white,/area/space)
"wq" = (/turf/simulated/floor/tiled/dark,/area/space)
"ww" = (/obj/structure/table/home_wooden,/obj/item/weapon/material/ashtray/bronze{pixel_x = 6},/obj/effect/floor_decal/corner/red{dir = 4},/turf/simulated/floor/tiled,/area/space)
"xw" = (/obj/machinery/door/unpowered/manhattan/wood/east,/obj/effect/floor_decal/spline/plain{dir = 8},/turf/simulated/floor/wood/walnut,/area/space)
"xE" = (/obj/structure/table/marble,/obj/effect/floor_decal/corner/black/border{dir = 1},/obj/effect/floor_decal/corner/black,/turf/simulated/floor/tiled/white,/area/space)
"xQ" = (/obj/effect/floor_decal/corner/black/border{dir = 4},/obj/effect/floor_decal/corner/black{dir = 1},/turf/simulated/floor/tiled/white,/area/space)
"yh" = (/obj/structure/table/marble,/obj/effect/floor_decal/corner/black/border{dir = 5},/turf/simulated/floor/tiled/white,/area/space)
"zs" = (/obj/structure/neon_spline/orange,/obj/structure/neon_spline/orange{dir = 1},/obj/structure/window/reinforced,/turf/simulated/floor/tiled/dark,/area/space)
"BG" = (/obj/structure/bed/chair/wood/walnut,/turf/simulated/floor/wood/walnut,/area/space)
"CH" = (/obj/machinery/light/colored/orange,/obj/item/weapon/reagent_containers/food/drinks/flask/detflask,/obj/structure/table/woodentable/walnut,/turf/simulated/floor/wood/walnut,/area/space)
"Da" = (/obj/machinery/modular_computer/console/preset/security{dir = 1; icon_state = "console"},/turf/simulated/floor/wood/walnut,/area/space)
"Ec" = (/obj/item/weapon/paper_bin{pixel_x = -5},/obj/item/weapon/pen,/obj/structure/table/woodentable/walnut,/obj/item/device/flashlight/lamp/alt{pixel_x = 7; pixel_y = 11},/turf/simulated/floor/wood/walnut,/area/space)
"Fs" = (/obj/machinery/washing_machine{pixel_x = 6},/obj/effect/floor_decal/corner/paleblue{dir = 5},/obj/structure/neon_spline/lightblue{dir = 1},/turf/simulated/floor/tiled/white,/area/space)
"GC" = (/obj/structure/sink/kitchen{dir = 4; icon_state = "sink_alt"; pixel_x = -13},/obj/effect/floor_decal/corner/black/border{dir = 8},/obj/effect/floor_decal/corner/black,/turf/simulated/floor/tiled/white,/area/space)
"GQ" = (/obj/machinery/light/colored{dir = 1; tag = null},/obj/structure/coatrack{pixel_x = -6},/obj/structure/flora/pottedplant/thinbush{pixel_x = 10},/obj/structure/neon_spline/orange{dir = 4},/obj/effect/floor_decal/corner/red{dir = 6},/turf/simulated/floor/tiled/dark,/area/space)
"JQ" = (/obj/machinery/cooker/grill,/obj/effect/floor_decal/corner/black{dir = 1},/turf/simulated/floor/tiled/white,/area/space)
"JV" = (/obj/structure/painting_custom{icon_state = "1,16"; name = "zakat neba painting"; pixel_y = -31},/obj/structure/neon_spline/orange{dir = 8},/turf/simulated/floor/tiled/dark,/area/space)
"KC" = (/obj/effect/wallframe_spawn/basic,/obj/structure/curtain/color/red,/turf/simulated/floor/plating,/area/space)
"Lb" = (/obj/structure/closet/cabinet,/turf/simulated/floor/wood/walnut,/area/space)
"LN" = (/obj/structure/toilet{pixel_y = 11},/obj/machinery/light_switch{dir = 4; override_automatic_dir_pixel_offset = 1; pixel_x = -27; pixel_y = -8},/obj/effect/floor_decal/corner/paleblue{dir = 5},/obj/structure/neon_spline/lightblue{dir = 1},/turf/simulated/floor/tiled/white,/area/space)
"Nb" = (/obj/machinery/light/colored/purple{dir = 1},/turf/simulated/open,/area/space)
"OJ" = (/obj/machinery/door/unpowered/manhattan/wood/east,/obj/effect/floor_decal/spline/plain{dir = 8},/turf/simulated/floor/tiled/white,/area/space)
"QD" = (/obj/structure/bed/chair/sofa/black/right{dir = 4; icon_state = "sofaend_right"},/turf/simulated/floor/carpet/bcarpet,/area/space)
"QK" = (/turf/simulated/floor/wood/walnut,/area/space)
"TB" = (/obj/effect/floor_decal/corner/red{dir = 1},/turf/simulated/floor/tiled,/area/space)
"VC" = (/turf/simulated/floor/carpet/bcarpet,/area/space)
"VS" = (/obj/structure/railing,/obj/effect/floor_decal/corner/red/border,/obj/structure/neon_spline/red,/turf/simulated/floor/tiled/monotile,/area/space)
"WY" = (/obj/machinery/microwave{pixel_y = 7},/obj/structure/painting_custom{icon_state = "10,6"; name = "red rose painting"; pixel_x = -30},/obj/structure/table/marble,/obj/effect/floor_decal/corner/black/border{dir = 9},/obj/effect/floor_decal/corner/black,/turf/simulated/floor/tiled/white,/area/space)
"Xd" = (/obj/machinery/light/colored,/turf/simulated/floor/tiled/white,/area/space)
"Xe" = (/turf/simulated/floor/tiled/white,/area/space)
"XL" = (/obj/structure/neon_spline/orange/corner{dir = 4},/obj/structure/neon_spline/orange/corner{dir = 8},/turf/simulated/floor/tiled/dark,/area/space)
"XS" = (/obj/effect/wallframe_spawn/basic,/obj/structure/curtain/color/red{dir = 8; icon_state = "closed"},/turf/simulated/floor/plating,/area/space)
"Ze" = (/obj/effect/floor_decal/corner/red{dir = 5},/turf/simulated/floor/tiled,/area/space)
"ZS" = (/obj/structure/painting_custom{icon_state = "13,7"; name = "water lily painting"; pixel_x = 30},/turf/simulated/floor/wood/walnut,/area/space)

(1,1,1) = {"
qUqUqUqUjeqUqUqUqUqUqUqUqU
qUfCaZjolUGQqUhPLbvmtKsvqU
XSQDvgVClUswxwQKQKBGQKZSqU
qUbizszsXLiSqUjBEcCHDaQKqU
qUWYxEyhlUswqUqUqUqUqUqUqU
qUGCkFxQlUsqhpqULNwcjwFsqU
qUdLJQbUJVwqwqOJXeXeXdjyqU
qUqUKCqUqUKCfoqUqUqUqUqUqU
nfnfnfcOwwvfZeZeTBhJnfnfnf
nfnfnfqUVSVSVSVSVSqUnfnfnf
nfnfnfNbnfnfnfnfnfNbnfnfnf
"}
