"a" = (/turf/simulated/mineral/impassable,/area/mine)
"b" = (/obj/effect/mining_generation_marker,/turf/simulated/floor,/area/mine)
"c" = (/turf/simulated/floor,/area/mine)
"d" = (/turf/space,/area/space)
"e" = (/obj/effect/interior_spawn,/turf/space,/area/space)

(1,1,1) = {"
dddddddddddddddddddddddddddddddddddddddddddddddddddddddddddddddddddddddddddddddddddddddddddddddddddd
dddddddddddddddddddddddddddddddddddddddddddddddddddddddddddddddddddddddddddddddddddddddddddddddddddd
dddddddddddddddddddddddddddddddddddddddddddddddddddddddddddddddddddddddddddddddddddddddddddddddddddd
dddddddddddddddddddddddddddddddddddddddddddddddddddddddddddddddddddddddddddddddddddddddddddddddddddd
dddddddddddddddddddddddddddddddddddddddddddddddddddddddddddddddddddddddddddddddddddddddddddddddddddd
dddddddddddddddddddddddddddddddddddddddddddddddddddddddddddddddddddddddddddddddddddddddddddddddddddd
dddddddddddddddddddddddddddddddddddddddddddddddddddddddddddddddddddddddddddddddddddddddddddddddddddd
dddddddddddddddddddddddddddddddddddddddddddddddddddddddddddddddddddddddddddddddddddddddddddddddddddd
dddddddedddddddddddddddddddddddddddedddddddedddddddddddddddddddddddddddeddddddddddddddddddddeddddddd
dddddddddddddddddddddddddddddddddddddddddddddddddddddddddddddddddddddddddddddddddddddddddddddddddddd
dddddddddddddddddddddddddddddddddddddddddddddddddddddddddddddddddddddddddddddddddddddddddddddddddddd
dddddddddddddddddddddddddddddddddddddddddddddddddddddddddddddddddddddddddddddddddddddddddddddddddddd
dddddddddddddddddddddddddddddddddddddddddddddddddddddddddddddddddddddddddddddddddddddddddddddddddddd
dddddddddddddddddddddddddddddddddddddddddddddddddddddddddddddddddddddddddddddddddddddddddddddddddddd
dddddddddddddddddddddddddddddddddddddddddddddddddddddddddddddddddddddddddddddddddddddddddddddddddddd
dddddddddddddddddddddddddddddddddddddddddddddddddddddddddddddddddddddddddddddddddddddddddddddddddddd
dddddddddddddddddddddddddddddddddddddddddddddddddddddddddddddddddddddddddddddddddddddddddddddddddddd
dddddddddddddddddddddddddddddddddddddddddddddddddddddddddddddddddddddddddddddddddddddddddddddddddddd
aaaaaaaaaaaaaaaaaaaaaaaaaaaaaaaaaaaaaaaaaaaaaaaaaaaaaaaaaaaaaaaaaaaaaaaaaaaaaaaaaadddddddddddddddddd
abcccccccccccccccccccccccccccccccccccccccccccccccccccccccccccccccccccccccccccccccadddddddddddddddddd
accccccccccccccccccccccccccccccccccccccccccccccccccccccccccccccccccccccccccccccccadddddddddddddddddd
accccccccccccccccccccccccccccccccccccccccccccccccccccccccccccccccccccccccccccccccadddddddddddddddddd
accccccccccccccccccccccccccccccccccccccccccccccccccccccccccccccccccccccccccccccccadddddddddddddddddd
accccccccccccccccccccccccccccccccccccccccccccccccccccccccccccccccccccccccccccccccadddddddddddddddddd
accccccccccccccccccccccccccccccccccccccccccccccccccccccccccccccccccccccccccccccccadddddddddddddddddd
accccccccccccccccccccccccccccccccccccccccccccccccccccccccccccccccccccccccccccccccadddddddddddddddddd
accccccccccccccccccccccccccccccccccccccccccccccccccccccccccccccccccccccccccccccccaddddddddddeddddddd
accccccccccccccccccccccccccccccccccccccccccccccccccccccccccccccccccccccccccccccccadddddddddddddddddd
accccccccccccccccccccccccccccccccccccccccccccccccccccccccccccccccccccccccccccccccadddddddddddddddddd
accccccccccccccccccccccccccccccccccccccccccccccccccccccccccccccccccccccccccccccccadddddddddddddddddd
accccccccccccccccccccccccccccccccccccccccccccccccccccccccccccccccccccccccccccccccadddddddddddddddddd
accccccccccccccccccccccccccccccccccccccccccccccccccccccccccccccccccccccccccccccccadddddddddddddddddd
accccccccccccccccccccccccccccccccccccccccccccccccccccccccccccccccccccccccccccccccadddddddddddddddddd
accccccccccccccccccccccccccccccccccccccccccccccccccccccccccccccccccccccccccccccccadddddddddddddddddd
accccccccccccccccccccccccccccccccccccccccccccccccccccccccccccccccccccccccccccccccadddddddddddddddddd
accccccccccccccccccccccccccccccccccccccccccccccccccccccccccccccccccccccccccccccccadddddddddddddddddd
accccccccccccccccccccccccccccccccccccccccccccccccccccccccccccccccccccccccccccccccadddddddddddddddddd
accccccccccccccccccccccccccccccccccccccccccccccccccccccccccccccccccccccccccccccccadddddddddddddddddd
accccccccccccccccccccccccccccccccccccccccccccccccccccccccccccccccccccccccccccccccadddddddddddddddddd
accccccccccccccccccccccccccccccccccccccccccccccccccccccccccccccccccccccccccccccccadddddddddddddddddd
accccccccccccccccccccccccccccccccccccccccccccccccccccccccccccccccccccccccccccccccadddddddddddddddddd
accccccccccccccccccccccccccccccccccccccccccccccccccccccccccccccccccccccccccccccccadddddddddddddddddd
accccccccccccccccccccccccccccccccccccccccccccccccccccccccccccccccccccccccccccccccadddddddddddddddddd
accccccccccccccccccccccccccccccccccccccccccccccccccccccccccccccccccccccccccccccccadddddddddddddddddd
accccccccccccccccccccccccccccccccccccccccccccccccccccccccccccccccccccccccccccccccaddddddddddeddddddd
accccccccccccccccccccccccccccccccccccccccccccccccccccccccccccccccccccccccccccccccadddddddddddddddddd
accccccccccccccccccccccccccccccccccccccccccccccccccccccccccccccccccccccccccccccccadddddddddddddddddd
accccccccccccccccccccccccccccccccccccccccccccccccccccccccccccccccccccccccccccccccadddddddddddddddddd
accccccccccccccccccccccccccccccccccccccccccccccccccccccccccccccccccccccccccccccccadddddddddddddddddd
accccccccccccccccccccccccccccccccccccccccccccccccccccccccccccccccccccccccccccccccadddddddddddddddddd
accccccccccccccccccccccccccccccccccccccccccccccccccccccccccccccccccccccccccccccccadddddddddddddddddd
accccccccccccccccccccccccccccccccccccccccccccccccccccccccccccccccccccccccccccccccadddddddddddddddddd
accccccccccccccccccccccccccccccccccccccccccccccccccccccccccccccccccccccccccccccccadddddddddddddddddd
accccccccccccccccccccccccccccccccccccccccccccccccccccccccccccccccccccccccccccccccadddddddddddddddddd
accccccccccccccccccccccccccccccccccccccccccccccccccccccccccccccccccccccccccccccccadddddddddddddddddd
accccccccccccccccccccccccccccccccccccccccccccccccccccccccccccccccccccccccccccccccadddddddddddddddddd
accccccccccccccccccccccccccccccccccccccccccccccccccccccccccccccccccccccccccccccccadddddddddddddddddd
accccccccccccccccccccccccccccccccccccccccccccccccccccccccccccccccccccccccccccccccadddddddddddddddddd
accccccccccccccccccccccccccccccccccccccccccccccccccccccccccccccccccccccccccccccccadddddddddddddddddd
accccccccccccccccccccccccccccccccccccccccccccccccccccccccccccccccccccccccccccccccadddddddddddddddddd
accccccccccccccccccccccccccccccccccccccccccccccccccccccccccccccccccccccccccccccccadddddddddddddddddd
accccccccccccccccccccccccccccccccccccccccccccccccccccccccccccccccccccccccccccccccadddddddddddddddddd
accccccccccccccccccccccccccccccccccccccccccccccccccccccccccccccccccccccccccccccccaddddddddddeddddddd
accccccccccccccccccccccccccccccccccccccccccccccccccccccccccccccccccccccccccccccccadddddddddddddddddd
accccccccccccccccccccccccccccccccccccccccccccccccccccccccccccccccccccccccccccccccadddddddddddddddddd
accccccccccccccccccccccccccccccccccccccccccccccccccccccccccccccccccccccccccccccccadddddddddddddddddd
accccccccccccccccccccccccccccccccccccccccccccccccccccccccccccccccccccccccccccccccadddddddddddddddddd
accccccccccccccccccccccccccccccccccccccccccccccccccccccccccccccccccccccccccccccccadddddddddddddddddd
accccccccccccccccccccccccccccccccccccccccccccccccccccccccccccccccccccccccccccccccadddddddddddddddddd
accccccccccccccccccccccccccccccccccccccccccccccccccccccccccccccccccccccccccccccccadddddddddddddddddd
accccccccccccccccccccccccccccccccccccccccccccccccccccccccccccccccccccccccccccccccadddddddddddddddddd
accccccccccccccccccccccccccccccccccccccccccccccccccccccccccccccccccccccccccccccccadddddddddddddddddd
accccccccccccccccccccccccccccccccccccccccccccccccccccccccccccccccccccccccccccccccadddddddddddddddddd
accccccccccccccccccccccccccccccccccccccccccccccccccccccccccccccccccccccccccccccccadddddddddddddddddd
accccccccccccccccccccccccccccccccccccccccccccccccccccccccccccccccccccccccccccccccadddddddddddddddddd
accccccccccccccccccccccccccccccccccccccccccccccccccccccccccccccccccccccccccccccccadddddddddddddddddd
accccccccccccccccccccccccccccccccccccccccccccccccccccccccccccccccccccccccccccccccadddddddddddddddddd
accccccccccccccccccccccccccccccccccccccccccccccccccccccccccccccccccccccccccccccccadddddddddddddddddd
accccccccccccccccccccccccccccccccccccccccccccccccccccccccccccccccccccccccccccccccadddddddddddddddddd
accccccccccccccccccccccccccccccccccccccccccccccccccccccccccccccccccccccccccccccccadddddddddddddddddd
accccccccccccccccccccccccccccccccccccccccccccccccccccccccccccccccccccccccccccccccaddddddddddeddddddd
accccccccccccccccccccccccccccccccccccccccccccccccccccccccccccccccccccccccccccccccadddddddddddddddddd
accccccccccccccccccccccccccccccccccccccccccccccccccccccccccccccccccccccccccccccccadddddddddddddddddd
accccccccccccccccccccccccccccccccccccccccccccccccccccccccccccccccccccccccccccccccadddddddddddddddddd
accccccccccccccccccccccccccccccccccccccccccccccccccccccccccccccccccccccccccccccccadddddddddddddddddd
accccccccccccccccccccccccccccccccccccccccccccccccccccccccccccccccccccccccccccccccadddddddddddddddddd
accccccccccccccccccccccccccccccccccccccccccccccccccccccccccccccccccccccccccccccccadddddddddddddddddd
accccccccccccccccccccccccccccccccccccccccccccccccccccccccccccccccccccccccccccccccadddddddddddddddddd
accccccccccccccccccccccccccccccccccccccccccccccccccccccccccccccccccccccccccccccccadddddddddddddddddd
accccccccccccccccccccccccccccccccccccccccccccccccccccccccccccccccccccccccccccccccadddddddddddddddddd
accccccccccccccccccccccccccccccccccccccccccccccccccccccccccccccccccccccccccccccccadddddddddddddddddd
accccccccccccccccccccccccccccccccccccccccccccccccccccccccccccccccccccccccccccccccadddddddddddddddddd
accccccccccccccccccccccccccccccccccccccccccccccccccccccccccccccccccccccccccccccccadddddddddddddddddd
accccccccccccccccccccccccccccccccccccccccccccccccccccccccccccccccccccccccccccccccadddddddddddddddddd
accccccccccccccccccccccccccccccccccccccccccccccccccccccccccccccccccccccccccccccccadddddddddddddddddd
accccccccccccccccccccccccccccccccccccccccccccccccccccccccccccccccccccccccccccccccadddddddddddddddddd
accccccccccccccccccccccccccccccccccccccccccccccccccccccccccccccccccccccccccccccccadddddddddddddddddd
accccccccccccccccccccccccccccccccccccccccccccccccccccccccccccccccccccccccccccccccadddddddddddddddddd
accccccccccccccccccccccccccccccccccccccccccccccccccccccccccccccccccccccccccccccccadddddddddddddddddd
aaaaaaaaaaaaaaaaaaaaaaaaaaaaaaaaaaaaaaaaaaaaaaaaaaaaaaaaaaaaaaaaaaaaaaaaaaaaaaaaaadddddddddddddddddd
"}
