"a" = (/turf/simulated/mineral/impassable,/area/mine)
"b" = (/obj/effect/mining_generation_marker,/turf/simulated/floor,/area/mine)
"c" = (/turf/simulated/floor,/area/mine)
"e" = (/turf/space,/area/space)

(1,1,1) = {"
eeeeeeeeeeeeeeeeeeeeeeeeeeeeeeeeeeeeeeeeeeeeeeeeeeeeeeeeeeeeeeeeeeeeeeeeeeeeeeeeeeeeeeeeeeeeeeeeeeee
eeeeeeeeeeeeeeeeeeeeeeeeeeeeeeeeeeeeeeeeeeeeeeeeeeeeeeeeeeeeeeeeeeeeeeeeeeeeeeeeeeeeeeeeeeeeeeeeeeee
eeeeeeeeeeeeeeeeeeeeeeeeeeeeeeeeeeeeeeeeeeeeeeeeeeeeeeeeeeeeeeeeeeeeeeeeeeeeeeeeeeeeeeeeeeeeeeeeeeee
eeeeeeeeeeeeeeeeeeeeeeeeeeeeeeeeeeeeeeeeeeeeeeeeeeeeeeeeeeeeeeeeeeeeeeeeeeeeeeeeeeeeeeeeeeeeeeeeeeee
eeeeeeeeeeeeeeeeeeeeeeeeeeeeeeeeeeeeeeeeeeeeeeeeeeeeeeeeeeeeeeeeeeeeeeeeeeeeeeeeeeeeeeeeeeeeeeeeeeee
eeeeeeeeeeeeeeeeeeeeeeeeeeeeeeeeeeeeeeeeeeeeeeeeeeeeeeeeeeeeeeeeeeeeeeeeeeeeeeeeeeeeeeeeeeeeeeeeeeee
eeeeeeeeeeeeeeeeeeeeeeeeeeeeeeeeeeeeeeeeeeeeeeeeeeeeeeeeeeeeeeeeeeeeeeeeeeeeeeeeeeeeeeeeeeeeeeeeeeee
eeeeeeeeeeeeeeeeeeeeeeeeeeeeeeeeeeeeeeeeeeeeeeeeeeeeeeeeeeeeeeeeeeeeeeeeeeeeeeeeeeeeeeeeeeeeeeeeeeee
eeeeeeeeeeeeeeeeeeeeeeeeeeeeeeeeeeeeeeeeeeeeeeeeeeeeeeeeeeeeeeeeeeeeeeeeeeeeeeeeeeeeeeeeeeeeeeeeeeee
eeeeeeeeeeeeeeeeeeeeeeeeeeeeeeeeeeeeeeeeeeeeeeeeeeeeeeeeeeeeeeeeeeeeeeeeeeeeeeeeeeeeeeeeeeeeeeeeeeee
eeeeeeeeeeeeeeeeeeeeeeeeeeeeeeeeeeeeeeeeeeeeeeeeeeeeeeeeeeeeeeeeeeeeeeeeeeeeeeeeeeeeeeeeeeeeeeeeeeee
eeeeeeeeeeeeeeeeeeeeeeeeeeeeeeeeeeeeeeeeeeeeeeeeeeeeeeeeeeeeeeeeeeeeeeeeeeeeeeeeeeeeeeeeeeeeeeeeeeee
eeeeeeeeeeeeeeeeeeeeeeeeeeeeeeeeeeeeeeeeeeeeeeeeeeeeeeeeeeeeeeeeeeeeeeeeeeeeeeeeeeeeeeeeeeeeeeeeeeee
eeeeeeeeeeeeeeeeeeeeeeeeeeeeeeeeeeeeeeeeeeeeeeeeeeeeeeeeeeeeeeeeeeeeeeeeeeeeeeeeeeeeeeeeeeeeeeeeeeee
eeeeeeeeeeeeeeeeeeeeeeeeeeeeeeeeeeeeeeeeeeeeeeeeeeeeeeeeeeeeeeeeeeeeeeeeeeeeeeeeeeeeeeeeeeeeeeeeeeee
eeeeeeeeeeeeeeeeeeeeeeeeeeeeeeeeeeeeeeeeeeeeeeeeeeeeeeeeeeeeeeeeeeeeeeeeeeeeeeeeeeeeeeeeeeeeeeeeeeee
eeeeeeeeeeeeeeeeeeeeeeeeeeeeeeeeeeeeeeeeeeeeeeeeeeeeeeeeeeeeeeeeeeeeeeeeeeeeeeeeeeeeeeeeeeeeeeeeeeee
eeeeeeeeeeeeeeeeeeeeeeeeeeeeeeeeeeeeeeeeeeeeeeeeeeeeeeeeeeeeeeeeeeeeeeeeeeeeeeeeeeeeeeeeeeeeeeeeeeee
aaaaaaaaaaaaaaaaaaaaaaaaaaaaaaaaaaaaaaaaaaaaaaaaaaaaaaaaaaaaaaaaaaaaaaaaaaaaaaaaaaeeeeeeeeeeeeeeeeee
abcccccccccccccccccccccccccccccccccccccccccccccccccccccccccccccccccccccccccccccccaeeeeeeeeeeeeeeeeee
accccccccccccccccccccccccccccccccccccccccccccccccccccccccccccccccccccccccccccccccaeeeeeeeeeeeeeeeeee
accccccccccccccccccccccccccccccccccccccccccccccccccccccccccccccccccccccccccccccccaeeeeeeeeeeeeeeeeee
accccccccccccccccccccccccccccccccccccccccccccccccccccccccccccccccccccccccccccccccaeeeeeeeeeeeeeeeeee
accccccccccccccccccccccccccccccccccccccccccccccccccccccccccccccccccccccccccccccccaeeeeeeeeeeeeeeeeee
accccccccccccccccccccccccccccccccccccccccccccccccccccccccccccccccccccccccccccccccaeeeeeeeeeeeeeeeeee
accccccccccccccccccccccccccccccccccccccccccccccccccccccccccccccccccccccccccccccccaeeeeeeeeeeeeeeeeee
accccccccccccccccccccccccccccccccccccccccccccccccccccccccccccccccccccccccccccccccaeeeeeeeeeeeeeeeeee
accccccccccccccccccccccccccccccccccccccccccccccccccccccccccccccccccccccccccccccccaeeeeeeeeeeeeeeeeee
accccccccccccccccccccccccccccccccccccccccccccccccccccccccccccccccccccccccccccccccaeeeeeeeeeeeeeeeeee
accccccccccccccccccccccccccccccccccccccccccccccccccccccccccccccccccccccccccccccccaeeeeeeeeeeeeeeeeee
accccccccccccccccccccccccccccccccccccccccccccccccccccccccccccccccccccccccccccccccaeeeeeeeeeeeeeeeeee
accccccccccccccccccccccccccccccccccccccccccccccccccccccccccccccccccccccccccccccccaeeeeeeeeeeeeeeeeee
accccccccccccccccccccccccccccccccccccccccccccccccccccccccccccccccccccccccccccccccaeeeeeeeeeeeeeeeeee
accccccccccccccccccccccccccccccccccccccccccccccccccccccccccccccccccccccccccccccccaeeeeeeeeeeeeeeeeee
accccccccccccccccccccccccccccccccccccccccccccccccccccccccccccccccccccccccccccccccaeeeeeeeeeeeeeeeeee
accccccccccccccccccccccccccccccccccccccccccccccccccccccccccccccccccccccccccccccccaeeeeeeeeeeeeeeeeee
accccccccccccccccccccccccccccccccccccccccccccccccccccccccccccccccccccccccccccccccaeeeeeeeeeeeeeeeeee
accccccccccccccccccccccccccccccccccccccccccccccccccccccccccccccccccccccccccccccccaeeeeeeeeeeeeeeeeee
accccccccccccccccccccccccccccccccccccccccccccccccccccccccccccccccccccccccccccccccaeeeeeeeeeeeeeeeeee
accccccccccccccccccccccccccccccccccccccccccccccccccccccccccccccccccccccccccccccccaeeeeeeeeeeeeeeeeee
accccccccccccccccccccccccccccccccccccccccccccccccccccccccccccccccccccccccccccccccaeeeeeeeeeeeeeeeeee
accccccccccccccccccccccccccccccccccccccccccccccccccccccccccccccccccccccccccccccccaeeeeeeeeeeeeeeeeee
accccccccccccccccccccccccccccccccccccccccccccccccccccccccccccccccccccccccccccccccaeeeeeeeeeeeeeeeeee
accccccccccccccccccccccccccccccccccccccccccccccccccccccccccccccccccccccccccccccccaeeeeeeeeeeeeeeeeee
accccccccccccccccccccccccccccccccccccccccccccccccccccccccccccccccccccccccccccccccaeeeeeeeeeeeeeeeeee
accccccccccccccccccccccccccccccccccccccccccccccccccccccccccccccccccccccccccccccccaeeeeeeeeeeeeeeeeee
accccccccccccccccccccccccccccccccccccccccccccccccccccccccccccccccccccccccccccccccaeeeeeeeeeeeeeeeeee
accccccccccccccccccccccccccccccccccccccccccccccccccccccccccccccccccccccccccccccccaeeeeeeeeeeeeeeeeee
accccccccccccccccccccccccccccccccccccccccccccccccccccccccccccccccccccccccccccccccaeeeeeeeeeeeeeeeeee
accccccccccccccccccccccccccccccccccccccccccccccccccccccccccccccccccccccccccccccccaeeeeeeeeeeeeeeeeee
accccccccccccccccccccccccccccccccccccccccccccccccccccccccccccccccccccccccccccccccaeeeeeeeeeeeeeeeeee
accccccccccccccccccccccccccccccccccccccccccccccccccccccccccccccccccccccccccccccccaeeeeeeeeeeeeeeeeee
accccccccccccccccccccccccccccccccccccccccccccccccccccccccccccccccccccccccccccccccaeeeeeeeeeeeeeeeeee
accccccccccccccccccccccccccccccccccccccccccccccccccccccccccccccccccccccccccccccccaeeeeeeeeeeeeeeeeee
accccccccccccccccccccccccccccccccccccccccccccccccccccccccccccccccccccccccccccccccaeeeeeeeeeeeeeeeeee
accccccccccccccccccccccccccccccccccccccccccccccccccccccccccccccccccccccccccccccccaeeeeeeeeeeeeeeeeee
accccccccccccccccccccccccccccccccccccccccccccccccccccccccccccccccccccccccccccccccaeeeeeeeeeeeeeeeeee
accccccccccccccccccccccccccccccccccccccccccccccccccccccccccccccccccccccccccccccccaeeeeeeeeeeeeeeeeee
accccccccccccccccccccccccccccccccccccccccccccccccccccccccccccccccccccccccccccccccaeeeeeeeeeeeeeeeeee
accccccccccccccccccccccccccccccccccccccccccccccccccccccccccccccccccccccccccccccccaeeeeeeeeeeeeeeeeee
accccccccccccccccccccccccccccccccccccccccccccccccccccccccccccccccccccccccccccccccaeeeeeeeeeeeeeeeeee
accccccccccccccccccccccccccccccccccccccccccccccccccccccccccccccccccccccccccccccccaeeeeeeeeeeeeeeeeee
accccccccccccccccccccccccccccccccccccccccccccccccccccccccccccccccccccccccccccccccaeeeeeeeeeeeeeeeeee
accccccccccccccccccccccccccccccccccccccccccccccccccccccccccccccccccccccccccccccccaeeeeeeeeeeeeeeeeee
accccccccccccccccccccccccccccccccccccccccccccccccccccccccccccccccccccccccccccccccaeeeeeeeeeeeeeeeeee
accccccccccccccccccccccccccccccccccccccccccccccccccccccccccccccccccccccccccccccccaeeeeeeeeeeeeeeeeee
accccccccccccccccccccccccccccccccccccccccccccccccccccccccccccccccccccccccccccccccaeeeeeeeeeeeeeeeeee
accccccccccccccccccccccccccccccccccccccccccccccccccccccccccccccccccccccccccccccccaeeeeeeeeeeeeeeeeee
accccccccccccccccccccccccccccccccccccccccccccccccccccccccccccccccccccccccccccccccaeeeeeeeeeeeeeeeeee
accccccccccccccccccccccccccccccccccccccccccccccccccccccccccccccccccccccccccccccccaeeeeeeeeeeeeeeeeee
accccccccccccccccccccccccccccccccccccccccccccccccccccccccccccccccccccccccccccccccaeeeeeeeeeeeeeeeeee
accccccccccccccccccccccccccccccccccccccccccccccccccccccccccccccccccccccccccccccccaeeeeeeeeeeeeeeeeee
accccccccccccccccccccccccccccccccccccccccccccccccccccccccccccccccccccccccccccccccaeeeeeeeeeeeeeeeeee
accccccccccccccccccccccccccccccccccccccccccccccccccccccccccccccccccccccccccccccccaeeeeeeeeeeeeeeeeee
accccccccccccccccccccccccccccccccccccccccccccccccccccccccccccccccccccccccccccccccaeeeeeeeeeeeeeeeeee
accccccccccccccccccccccccccccccccccccccccccccccccccccccccccccccccccccccccccccccccaeeeeeeeeeeeeeeeeee
accccccccccccccccccccccccccccccccccccccccccccccccccccccccccccccccccccccccccccccccaeeeeeeeeeeeeeeeeee
accccccccccccccccccccccccccccccccccccccccccccccccccccccccccccccccccccccccccccccccaeeeeeeeeeeeeeeeeee
accccccccccccccccccccccccccccccccccccccccccccccccccccccccccccccccccccccccccccccccaeeeeeeeeeeeeeeeeee
accccccccccccccccccccccccccccccccccccccccccccccccccccccccccccccccccccccccccccccccaeeeeeeeeeeeeeeeeee
accccccccccccccccccccccccccccccccccccccccccccccccccccccccccccccccccccccccccccccccaeeeeeeeeeeeeeeeeee
accccccccccccccccccccccccccccccccccccccccccccccccccccccccccccccccccccccccccccccccaeeeeeeeeeeeeeeeeee
accccccccccccccccccccccccccccccccccccccccccccccccccccccccccccccccccccccccccccccccaeeeeeeeeeeeeeeeeee
accccccccccccccccccccccccccccccccccccccccccccccccccccccccccccccccccccccccccccccccaeeeeeeeeeeeeeeeeee
accccccccccccccccccccccccccccccccccccccccccccccccccccccccccccccccccccccccccccccccaeeeeeeeeeeeeeeeeee
accccccccccccccccccccccccccccccccccccccccccccccccccccccccccccccccccccccccccccccccaeeeeeeeeeeeeeeeeee
accccccccccccccccccccccccccccccccccccccccccccccccccccccccccccccccccccccccccccccccaeeeeeeeeeeeeeeeeee
accccccccccccccccccccccccccccccccccccccccccccccccccccccccccccccccccccccccccccccccaeeeeeeeeeeeeeeeeee
accccccccccccccccccccccccccccccccccccccccccccccccccccccccccccccccccccccccccccccccaeeeeeeeeeeeeeeeeee
accccccccccccccccccccccccccccccccccccccccccccccccccccccccccccccccccccccccccccccccaeeeeeeeeeeeeeeeeee
accccccccccccccccccccccccccccccccccccccccccccccccccccccccccccccccccccccccccccccccaeeeeeeeeeeeeeeeeee
accccccccccccccccccccccccccccccccccccccccccccccccccccccccccccccccccccccccccccccccaeeeeeeeeeeeeeeeeee
accccccccccccccccccccccccccccccccccccccccccccccccccccccccccccccccccccccccccccccccaeeeeeeeeeeeeeeeeee
accccccccccccccccccccccccccccccccccccccccccccccccccccccccccccccccccccccccccccccccaeeeeeeeeeeeeeeeeee
accccccccccccccccccccccccccccccccccccccccccccccccccccccccccccccccccccccccccccccccaeeeeeeeeeeeeeeeeee
accccccccccccccccccccccccccccccccccccccccccccccccccccccccccccccccccccccccccccccccaeeeeeeeeeeeeeeeeee
accccccccccccccccccccccccccccccccccccccccccccccccccccccccccccccccccccccccccccccccaeeeeeeeeeeeeeeeeee
accccccccccccccccccccccccccccccccccccccccccccccccccccccccccccccccccccccccccccccccaeeeeeeeeeeeeeeeeee
accccccccccccccccccccccccccccccccccccccccccccccccccccccccccccccccccccccccccccccccaeeeeeeeeeeeeeeeeee
aaaaaaaaaaaaaaaaaaaaaaaaaaaaaaaaaaaaaaaaaaaaaaaaaaaaaaaaaaaaaaaaaaaaaaaaaaaaaaaaaaeeeeeeeeeeeeeeeeee
"}
