"a" = (/turf/template_noop,/area/template_noop)
"b" = (/obj/effect/decal/cleanable/dirt,/turf/template_noop,/area/template_noop)
"c" = (/obj/structure/boulder,/turf/template_noop,/area/template_noop)
"d" = (/obj/structure/sculpting_block/sculpted/large/pillar{alpha = 200; anchored = 1},/turf/template_noop,/area/template_noop)
"e" = (/obj/effect/decal/cleanable/ash,/turf/template_noop,/area/template_noop)
"f" = (/obj/structure/neon_spline/purple/corner,/obj/effect/decal/cleanable/dirt,/turf/template_noop,/area/template_noop)
"g" = (/obj/structure/neon_spline/purple,/turf/template_noop,/area/template_noop)
"h" = (/obj/structure/neon_spline/purple/corner{dir = 8},/obj/effect/decal/cleanable/dirt,/turf/template_noop,/area/template_noop)
"i" = (/obj/structure/neon_spline/purple{dir = 4; icon_state = "spline_fancy"},/turf/template_noop,/area/template_noop)
"j" = (/turf/simulated/floor/tiled/monotile_dark,/area/template_noop)
"k" = (/obj/structure/neon_spline/purple{icon_state = "spline_fancy"; dir = 8},/obj/effect/decal/cleanable/dirt,/obj/effect/decal/cleanable/dirt,/turf/template_noop,/area/template_noop)
"l" = (/obj/effect/decal/cleanable/dirt,/obj/effect/decal/cleanable/dirt,/turf/template_noop,/area/template_noop)
"m" = (/obj/structure/neon_spline/purple{dir = 4; icon_state = "spline_fancy"},/obj/item/weapon/material/shard{icon_state = "medium"},/turf/template_noop,/area/template_noop)
"n" = (/obj/structure/table/alien,/obj/structure/window/reinforced{dir = 8},/obj/structure/window/reinforced{dir = 4},/obj/structure/window/reinforced{dir = 1},/turf/simulated/floor/tiled/monotile_dark,/area/template_noop)
"o" = (/obj/structure/neon_spline/purple{icon_state = "spline_fancy"; dir = 8},/obj/effect/decal/cleanable/dirt,/turf/template_noop,/area/template_noop)
"p" = (/obj/item/weapon/material/shard,/obj/effect/decal/remains/human,/turf/simulated/floor/tiled/monotile_dark,/area/template_noop)
"q" = (/obj/structure/boulder,/obj/effect/decal/cleanable/dirt,/turf/template_noop,/area/template_noop)
"r" = (/obj/structure/neon_spline/purple/corner{dir = 1; icon_state = "spline_fancy_corner"},/turf/template_noop,/area/template_noop)
"s" = (/obj/structure/neon_spline/purple{icon_state = "spline_fancy"; dir = 1},/turf/template_noop,/area/template_noop)
"t" = (/obj/structure/neon_spline/purple{icon_state = "spline_fancy"; dir = 1},/obj/effect/decal/cleanable/dirt,/turf/template_noop,/area/template_noop)
"u" = (/obj/structure/neon_spline/purple/corner{dir = 4; icon_state = "spline_fancy_corner"},/turf/template_noop,/area/template_noop)

(1,1,1) = {"
aaabaaaac
adaaabeda
aafggghba
aaijjjkba
blmjnjoba
aaijpjoqa
acrsstuaa
adaaaaada
aaeabacaa
"}
